year,pref,heatpoints,heatpoints_capitol,heatpoints_ytd,heatpoints_capitol_ytd,temp,8月9日時点,残りの期間,sort_n
2000,東京都,181,67,90,37,真夏日,37,30,1
2000,東京都,8,1,6,0,猛暑日,0,1,1
2000,北海道,33,10,18,6,真夏日,6,4,24
2000,北海道,3,2,3,2,猛暑日,2,0,24
2000,青森県,49,17,27,9,真夏日,9,8,31
2000,青森県,3,0,3,0,猛暑日,0,0,31
2000,秋田県,54,40,27,17,真夏日,17,23,32
2000,秋田県,4,4,3,3,猛暑日,3,1,32
2000,岩手県,57,34,36,21,真夏日,21,13,33
2000,岩手県,5,1,4,1,猛暑日,1,0,33
2000,宮城県,46,30,31,17,真夏日,17,13,34
2000,宮城県,2,0,1,0,猛暑日,0,0,34
2000,山形県,68,64,41,38,真夏日,38,26,35
2000,山形県,7,6,5,5,猛暑日,5,1,35
2000,福島県,76,64,45,41,真夏日,41,23,36
2000,福島県,13,8,9,7,猛暑日,7,1,36
2000,茨城県,75,49,45,32,真夏日,32,17,40
2000,茨城県,10,2,7,1,猛暑日,1,1,40
2000,栃木県,66,63,39,38,真夏日,38,25,41
2000,栃木県,4,2,3,1,猛暑日,1,1,41
2000,群馬県,72,67,45,42,真夏日,42,25,42
2000,群馬県,15,11,11,9,猛暑日,9,2,42
2000,埼玉県,80,61,50,37,真夏日,37,24,43
2000,埼玉県,16,3,12,2,猛暑日,2,1,43
2000,千葉県,79,60,42,31,真夏日,31,29,45
2000,千葉県,5,0,3,0,猛暑日,0,0,45
2000,神奈川県,62,54,35,30,真夏日,30,24,46
2000,神奈川県,3,1,1,0,猛暑日,0,1,46
2000,長野県,75,67,43,36,真夏日,36,31,48
2000,長野県,6,5,4,3,猛暑日,3,2,48
2000,山梨県,83,83,51,51,真夏日,51,32,49
2000,山梨県,12,10,8,7,猛暑日,7,3,49
2000,静岡県,87,53,49,26,真夏日,26,27,50
2000,静岡県,12,3,7,2,猛暑日,2,1,50
2000,愛知県,86,79,49,43,真夏日,43,36,51
2000,愛知県,29,25,13,10,猛暑日,10,15,51
2000,岐阜県,92,83,52,46,真夏日,46,37,52
2000,岐阜県,36,31,19,16,猛暑日,16,15,52
2000,三重県,87,63,50,34,真夏日,34,29,53
2000,三重県,29,6,15,4,猛暑日,4,2,53
2000,新潟県,74,55,40,26,真夏日,26,29,54
2000,新潟県,16,7,7,3,猛暑日,3,4,54
2000,富山県,64,63,33,33,真夏日,33,30,55
2000,富山県,14,13,8,7,猛暑日,7,6,55
2000,石川県,65,55,35,27,真夏日,27,28,56
2000,石川県,13,7,6,5,猛暑日,5,2,56
2000,福井県,81,70,43,38,真夏日,38,32,57
2000,福井県,11,10,3,3,猛暑日,3,7,57
2000,滋賀県,79,72,42,37,真夏日,37,35,60
2000,滋賀県,12,4,4,3,猛暑日,3,1,60
2000,京都府,92,88,54,51,真夏日,51,37,61
2000,京都府,33,27,16,14,猛暑日,14,13,61
2000,大阪府,89,85,50,46,真夏日,46,39,62
2000,大阪府,31,26,15,10,猛暑日,10,16,62
2000,兵庫県,93,79,54,41,真夏日,41,38,63
2000,兵庫県,36,8,17,5,猛暑日,5,3,63
2000,奈良県,83,78,48,43,真夏日,43,35,64
2000,奈良県,22,19,11,9,猛暑日,9,10,64
2000,和歌山県,87,78,48,40,真夏日,40,38,65
2000,和歌山県,11,8,7,5,猛暑日,5,3,65
2000,岡山県,90,82,53,47,真夏日,47,35,66
2000,岡山県,29,23,15,13,猛暑日,13,10,66
2000,広島県,92,72,54,38,真夏日,38,34,67
2000,広島県,17,6,7,1,猛暑日,1,5,67
2000,島根県,80,67,47,36,真夏日,36,31,68
2000,島根県,15,9,8,2,猛暑日,2,7,68
2000,鳥取県,80,76,46,43,真夏日,43,33,69
2000,鳥取県,21,14,10,5,猛暑日,5,9,69
2000,徳島県,89,72,51,36,真夏日,36,36,71
2000,徳島県,16,5,8,4,猛暑日,4,1,71
2000,香川県,90,85,51,49,真夏日,49,36,72
2000,香川県,30,15,12,8,猛暑日,8,7,72
2000,愛媛県,88,75,50,41,真夏日,41,34,73
2000,愛媛県,16,7,6,2,猛暑日,2,5,73
2000,高知県,87,74,49,38,真夏日,38,36,74
2000,高知県,7,4,5,2,猛暑日,2,2,74
2000,山口県,83,75,49,43,真夏日,43,32,81
2000,山口県,9,4,3,3,猛暑日,3,1,81
2000,福岡県,84,68,50,37,真夏日,37,31,82
2000,福岡県,13,5,10,4,猛暑日,4,1,82
2000,大分県,89,70,54,37,真夏日,37,33,83
2000,大分県,22,5,15,4,猛暑日,4,1,83
2000,長崎県,78,59,42,30,真夏日,30,29,84
2000,長崎県,8,5,4,3,猛暑日,3,2,84
2000,佐賀県,79,78,44,44,真夏日,44,34,85
2000,佐賀県,15,13,11,10,猛暑日,10,3,85
2000,熊本県,91,81,54,48,真夏日,48,33,86
2000,熊本県,19,15,14,12,猛暑日,12,3,86
2000,宮崎県,94,62,54,34,真夏日,34,28,87
2000,宮崎県,11,4,7,3,猛暑日,3,1,87
2000,鹿児島県,117,81,64,42,真夏日,42,39,88
2000,鹿児島県,9,7,5,3,猛暑日,3,4,88
2000,沖縄県,147,77,76,45,真夏日,45,32,91
2000,沖縄県,0,0,0,0,猛暑日,0,0,91
2001,東京都,136,52,73,36,真夏日,36,16,1
2001,東京都,16,8,16,8,猛暑日,8,0,1
2001,北海道,21,0,11,0,真夏日,0,0,24
2001,北海道,0,0,0,0,猛暑日,0,0,24
2001,青森県,23,5,14,4,真夏日,4,1,31
2001,青森県,0,0,0,0,猛暑日,0,0,31
2001,秋田県,36,17,22,4,真夏日,4,13,32
2001,秋田県,0,0,0,0,猛暑日,0,0,32
2001,岩手県,37,15,26,9,真夏日,9,6,33
2001,岩手県,2,0,2,0,猛暑日,0,0,33
2001,宮城県,19,15,17,14,真夏日,14,1,34
2001,宮城県,2,2,2,2,猛暑日,2,0,34
2001,山形県,50,37,32,27,真夏日,27,10,35
2001,山形県,2,2,2,2,猛暑日,2,0,35
2001,福島県,59,42,42,32,真夏日,32,10,36
2001,福島県,8,7,8,7,猛暑日,7,0,36
2001,茨城県,53,29,38,25,真夏日,25,4,40
2001,茨城県,16,9,16,9,猛暑日,9,0,40
2001,栃木県,47,45,35,34,真夏日,34,11,41
2001,栃木県,14,13,14,13,猛暑日,13,0,41
2001,群馬県,57,52,40,38,真夏日,38,14,42
2001,群馬県,16,15,16,15,猛暑日,15,0,42
2001,埼玉県,59,47,40,35,真夏日,35,12,43
2001,埼玉県,18,13,18,13,猛暑日,13,0,43
2001,千葉県,56,46,38,34,真夏日,34,12,45
2001,千葉県,15,3,13,3,猛暑日,3,0,45
2001,神奈川県,55,47,35,34,真夏日,34,13,46
2001,神奈川県,6,4,6,4,猛暑日,4,0,46
2001,長野県,72,50,48,36,真夏日,36,14,48
2001,長野県,21,2,19,2,猛暑日,2,0,48
2001,山梨県,74,74,46,46,真夏日,46,28,49
2001,山梨県,24,22,21,19,猛暑日,19,3,49
2001,静岡県,81,54,49,31,真夏日,31,23,50
2001,静岡県,18,5,18,5,猛暑日,5,0,50
2001,愛知県,77,70,47,44,真夏日,44,26,51
2001,愛知県,16,14,15,14,猛暑日,14,0,51
2001,岐阜県,85,76,52,45,真夏日,45,31,52
2001,岐阜県,19,17,16,16,猛暑日,16,1,52
2001,三重県,78,56,49,34,真夏日,34,22,53
2001,三重県,21,9,20,9,猛暑日,9,0,53
2001,新潟県,63,50,42,32,真夏日,32,18,54
2001,新潟県,10,3,7,3,猛暑日,3,0,54
2001,富山県,56,48,40,33,真夏日,33,15,55
2001,富山県,13,12,13,12,猛暑日,12,0,55
2001,石川県,52,47,36,34,真夏日,34,13,56
2001,石川県,5,2,5,2,猛暑日,2,0,56
2001,福井県,58,57,41,40,真夏日,40,17,57
2001,福井県,8,6,7,5,猛暑日,5,1,57
2001,滋賀県,63,54,44,38,真夏日,38,16,60
2001,滋賀県,8,3,7,3,猛暑日,3,0,60
2001,京都府,79,76,51,50,真夏日,50,26,61
2001,京都府,27,24,20,18,猛暑日,18,6,61
2001,大阪府,78,77,48,48,真夏日,48,29,62
2001,大阪府,29,21,22,15,猛暑日,15,6,62
2001,兵庫県,83,63,53,40,真夏日,40,23,63
2001,兵庫県,28,11,19,8,猛暑日,8,3,63
2001,奈良県,77,71,52,47,真夏日,47,24,64
2001,奈良県,25,17,23,15,猛暑日,15,2,64
2001,和歌山県,73,69,45,44,真夏日,44,25,65
2001,和歌山県,17,6,15,6,猛暑日,6,0,65
2001,岡山県,82,69,55,47,真夏日,47,22,66
2001,岡山県,25,23,21,20,猛暑日,20,3,66
2001,広島県,81,69,50,41,真夏日,41,28,67
2001,広島県,20,11,14,8,猛暑日,8,3,67
2001,島根県,63,49,43,34,真夏日,34,15,68
2001,島根県,16,12,13,9,猛暑日,9,3,68
2001,鳥取県,60,56,44,42,真夏日,42,14,69
2001,鳥取県,16,13,12,9,猛暑日,9,4,69
2001,徳島県,74,64,45,42,真夏日,42,22,71
2001,徳島県,8,6,6,5,猛暑日,5,1,71
2001,香川県,72,68,47,45,真夏日,45,23,72
2001,香川県,21,13,14,12,猛暑日,12,1,72
2001,愛媛県,78,64,49,41,真夏日,41,23,73
2001,愛媛県,25,9,19,5,猛暑日,5,4,73
2001,高知県,82,71,48,41,真夏日,41,30,74
2001,高知県,14,6,11,5,猛暑日,5,1,74
2001,山口県,74,69,44,40,真夏日,40,29,81
2001,山口県,20,13,15,10,猛暑日,10,3,81
2001,福岡県,81,56,51,38,真夏日,38,18,82
2001,福岡県,25,8,20,4,猛暑日,4,4,82
2001,大分県,86,58,56,39,真夏日,39,19,83
2001,大分県,28,5,23,5,猛暑日,5,0,83
2001,長崎県,75,60,44,32,真夏日,32,28,84
2001,長崎県,11,4,6,2,猛暑日,2,2,84
2001,佐賀県,77,74,45,45,真夏日,45,29,85
2001,佐賀県,21,21,18,18,猛暑日,18,3,85
2001,熊本県,97,82,53,43,真夏日,43,39,86
2001,熊本県,29,27,22,20,猛暑日,20,7,86
2001,宮崎県,86,65,54,47,真夏日,47,18,87
2001,宮崎県,20,7,18,5,猛暑日,5,2,87
2001,鹿児島県,113,79,65,47,真夏日,47,32,88
2001,鹿児島県,30,9,25,7,猛暑日,7,2,88
2001,沖縄県,143,102,81,61,真夏日,61,41,91
2001,沖縄県,1,1,1,1,猛暑日,1,0,91
2002,東京都,165,59,82,37,真夏日,37,22,1
2002,東京都,16,6,12,4,猛暑日,4,2,1
2002,北海道,16,2,12,2,真夏日,2,0,24
2002,北海道,0,0,0,0,猛暑日,0,0,24
2002,青森県,27,6,22,4,真夏日,4,2,31
2002,青森県,0,0,0,0,猛暑日,0,0,31
2002,秋田県,42,16,26,8,真夏日,8,8,32
2002,秋田県,1,1,1,1,猛暑日,1,0,32
2002,岩手県,35,20,25,12,真夏日,12,8,33
2002,岩手県,4,0,4,0,猛暑日,0,0,33
2002,宮城県,30,24,20,18,真夏日,18,6,34
2002,宮城県,4,2,4,2,猛暑日,2,0,34
2002,山形県,45,40,30,29,真夏日,29,11,35
2002,山形県,9,7,6,5,猛暑日,5,2,35
2002,福島県,59,46,37,31,真夏日,31,15,36
2002,福島県,14,13,9,9,猛暑日,9,4,36
2002,茨城県,63,45,41,27,真夏日,27,18,40
2002,茨城県,16,6,12,4,猛暑日,4,2,40
2002,栃木県,61,55,38,32,真夏日,32,23,41
2002,栃木県,10,10,8,8,猛暑日,8,2,41
2002,群馬県,69,61,44,39,真夏日,39,22,42
2002,群馬県,21,14,14,12,猛暑日,12,2,42
2002,埼玉県,71,52,45,33,真夏日,33,19,43
2002,埼玉県,26,9,15,7,猛暑日,7,2,43
2002,千葉県,67,53,41,33,真夏日,33,20,45
2002,千葉県,6,1,6,1,猛暑日,1,0,45
2002,神奈川県,60,54,37,33,真夏日,33,21,46
2002,神奈川県,5,1,5,1,猛暑日,1,0,46
2002,長野県,74,56,46,34,真夏日,34,22,48
2002,長野県,22,9,14,3,猛暑日,3,6,48
2002,山梨県,76,73,48,46,真夏日,46,27,49
2002,山梨県,19,18,14,13,猛暑日,13,5,49
2002,静岡県,83,59,48,33,真夏日,33,26,50
2002,静岡県,22,6,14,4,猛暑日,4,2,50
2002,愛知県,80,76,47,44,真夏日,44,32,51
2002,愛知県,24,21,15,12,猛暑日,12,9,51
2002,岐阜県,86,80,52,47,真夏日,47,33,52
2002,岐阜県,31,24,18,14,猛暑日,14,10,52
2002,三重県,79,60,50,36,真夏日,36,24,53
2002,三重県,12,4,9,4,猛暑日,4,0,53
2002,新潟県,63,39,38,25,真夏日,25,14,54
2002,新潟県,12,9,7,5,猛暑日,5,4,54
2002,富山県,54,50,36,33,真夏日,33,17,55
2002,富山県,12,11,7,7,猛暑日,7,4,55
2002,石川県,61,51,39,32,真夏日,32,19,56
2002,石川県,10,5,5,3,猛暑日,3,2,56
2002,福井県,64,57,42,37,真夏日,37,20,57
2002,福井県,14,10,10,6,猛暑日,6,4,57
2002,滋賀県,70,60,42,37,真夏日,37,23,60
2002,滋賀県,11,4,8,4,猛暑日,4,0,60
2002,京都府,86,84,53,52,真夏日,52,32,61
2002,京都府,27,23,15,14,猛暑日,14,9,61
2002,大阪府,89,86,53,52,真夏日,52,34,62
2002,大阪府,28,22,15,13,猛暑日,13,9,62
2002,兵庫県,94,63,56,36,真夏日,36,27,63
2002,兵庫県,30,8,21,6,猛暑日,6,2,63
2002,奈良県,83,74,53,47,真夏日,47,27,64
2002,奈良県,28,15,18,9,猛暑日,9,6,64
2002,和歌山県,82,67,49,39,真夏日,39,28,65
2002,和歌山県,12,5,10,4,猛暑日,4,1,65
2002,岡山県,86,80,53,51,真夏日,51,29,66
2002,岡山県,23,19,17,15,猛暑日,15,4,66
2002,広島県,86,77,50,41,真夏日,41,36,67
2002,広島県,17,10,10,5,猛暑日,5,5,67
2002,島根県,70,59,47,39,真夏日,39,20,68
2002,島根県,12,8,8,5,猛暑日,5,3,68
2002,鳥取県,69,66,44,42,真夏日,42,24,69
2002,鳥取県,14,10,9,7,猛暑日,7,3,69
2002,徳島県,80,66,46,37,真夏日,37,29,71
2002,徳島県,6,4,4,4,猛暑日,4,0,71
2002,香川県,89,82,53,50,真夏日,50,32,72
2002,香川県,22,9,11,7,猛暑日,7,2,72
2002,愛媛県,90,72,51,38,真夏日,38,34,73
2002,愛媛県,15,5,11,3,猛暑日,3,2,73
2002,高知県,93,70,54,37,真夏日,37,33,74
2002,高知県,8,1,6,1,猛暑日,1,0,74
2002,山口県,86,72,52,44,真夏日,44,28,81
2002,山口県,11,5,9,4,猛暑日,4,1,81
2002,福岡県,86,56,50,37,真夏日,37,19,82
2002,福岡県,19,2,16,2,猛暑日,2,0,82
2002,大分県,100,70,60,39,真夏日,39,31,83
2002,大分県,23,8,18,7,猛暑日,7,1,83
2002,長崎県,81,57,45,34,真夏日,34,23,84
2002,長崎県,3,1,1,0,猛暑日,0,1,84
2002,佐賀県,77,73,48,46,真夏日,46,27,85
2002,佐賀県,12,11,8,8,猛暑日,8,3,85
2002,熊本県,99,92,56,52,真夏日,52,40,86
2002,熊本県,16,14,10,8,猛暑日,8,6,86
2002,宮崎県,96,64,54,36,真夏日,36,28,87
2002,宮崎県,7,3,5,2,猛暑日,2,1,87
2002,鹿児島県,113,81,63,41,真夏日,41,40,88
2002,鹿児島県,7,5,2,1,猛暑日,1,4,88
2002,沖縄県,163,89,101,44,真夏日,44,45,91
2002,沖縄県,0,0,0,0,猛暑日,0,0,91
2003,東京都,149,38,69,14,真夏日,14,24,1
2003,東京都,9,0,1,0,猛暑日,0,0,1
2003,北海道,17,0,13,0,真夏日,0,0,24
2003,北海道,0,0,0,0,猛暑日,0,0,24
2003,青森県,13,2,8,1,真夏日,1,1,31
2003,青森県,0,0,0,0,猛暑日,0,0,31
2003,秋田県,16,7,12,5,真夏日,5,2,32
2003,秋田県,1,0,0,0,猛暑日,0,0,32
2003,岩手県,25,4,15,3,真夏日,3,1,33
2003,岩手県,0,0,0,0,猛暑日,0,0,33
2003,宮城県,18,9,8,3,真夏日,3,6,34
2003,宮城県,0,0,0,0,猛暑日,0,0,34
2003,山形県,30,23,15,12,真夏日,12,11,35
2003,山形県,0,0,0,0,猛暑日,0,0,35
2003,福島県,50,29,25,14,真夏日,14,15,36
2003,福島県,3,1,2,0,猛暑日,0,1,36
2003,茨城県,44,27,20,9,真夏日,9,18,40
2003,茨城県,5,0,2,0,猛暑日,0,0,40
2003,栃木県,40,36,17,16,真夏日,16,20,41
2003,栃木県,1,0,1,0,猛暑日,0,0,41
2003,群馬県,49,41,24,18,真夏日,18,23,42
2003,群馬県,11,5,4,2,猛暑日,2,3,42
2003,埼玉県,46,40,21,17,真夏日,17,23,43
2003,埼玉県,9,2,3,0,猛暑日,0,2,43
2003,千葉県,45,35,20,13,真夏日,13,22,45
2003,千葉県,7,0,2,0,猛暑日,0,0,45
2003,神奈川県,43,35,16,11,真夏日,11,24,46
2003,神奈川県,1,0,0,0,猛暑日,0,0,46
2003,長野県,63,30,31,14,真夏日,14,16,48
2003,長野県,7,1,2,0,猛暑日,0,1,48
2003,山梨県,60,55,27,24,真夏日,24,31,49
2003,山梨県,8,8,3,3,猛暑日,3,5,49
2003,静岡県,67,42,32,15,真夏日,15,27,50
2003,静岡県,6,1,1,0,猛暑日,0,1,50
2003,愛知県,62,51,26,18,真夏日,18,33,51
2003,愛知県,10,2,2,1,猛暑日,1,1,51
2003,岐阜県,68,55,31,21,真夏日,21,34,52
2003,岐阜県,16,10,2,2,猛暑日,2,8,52
2003,三重県,64,38,29,12,真夏日,12,26,53
2003,三重県,10,3,2,0,猛暑日,0,3,53
2003,新潟県,46,19,24,10,真夏日,10,9,54
2003,新潟県,2,1,1,0,猛暑日,0,1,54
2003,富山県,35,29,15,12,真夏日,12,17,55
2003,富山県,5,4,3,2,猛暑日,2,2,55
2003,石川県,41,31,19,14,真夏日,14,17,56
2003,石川県,2,1,1,0,猛暑日,0,1,56
2003,福井県,45,36,19,14,真夏日,14,22,57
2003,福井県,7,1,5,1,猛暑日,1,0,57
2003,滋賀県,50,36,16,10,真夏日,10,26,60
2003,滋賀県,2,0,2,0,猛暑日,0,0,60
2003,京都府,68,61,32,26,真夏日,26,35,61
2003,京都府,12,11,4,4,猛暑日,4,7,61
2003,大阪府,72,66,34,30,真夏日,30,36,62
2003,大阪府,11,7,1,1,猛暑日,1,6,62
2003,兵庫県,83,48,44,16,真夏日,16,32,63
2003,兵庫県,16,0,5,0,猛暑日,0,0,63
2003,奈良県,67,50,30,19,真夏日,19,31,64
2003,奈良県,9,0,1,0,猛暑日,0,0,64
2003,和歌山県,68,57,30,22,真夏日,22,35,65
2003,和歌山県,2,1,0,0,猛暑日,0,1,65
2003,岡山県,69,55,35,25,真夏日,25,30,66
2003,岡山県,6,3,2,0,猛暑日,0,3,66
2003,広島県,66,47,30,16,真夏日,16,31,67
2003,広島県,3,0,1,0,猛暑日,0,0,67
2003,島根県,55,32,23,12,真夏日,12,20,68
2003,島根県,3,1,1,1,猛暑日,1,0,68
2003,鳥取県,48,39,21,16,真夏日,16,23,69
2003,鳥取県,7,5,4,3,猛暑日,3,2,69
2003,徳島県,60,49,24,18,真夏日,18,31,71
2003,徳島県,5,1,1,0,猛暑日,0,1,71
2003,香川県,67,54,35,25,真夏日,25,29,72
2003,香川県,4,4,0,0,猛暑日,0,4,72
2003,愛媛県,79,54,41,23,真夏日,23,31,73
2003,愛媛県,20,0,5,0,猛暑日,0,0,73
2003,高知県,79,63,38,25,真夏日,25,38,74
2003,高知県,10,0,0,0,猛暑日,0,0,74
2003,山口県,58,40,26,16,真夏日,16,24,81
2003,山口県,3,2,0,0,猛暑日,0,2,81
2003,福岡県,77,49,39,21,真夏日,21,28,82
2003,福岡県,13,2,3,1,猛暑日,1,1,82
2003,大分県,82,47,46,19,真夏日,19,28,83
2003,大分県,20,1,6,1,猛暑日,1,0,83
2003,長崎県,71,47,34,20,真夏日,20,27,84
2003,長崎県,4,0,1,0,猛暑日,0,0,84
2003,佐賀県,66,61,31,28,真夏日,28,33,85
2003,佐賀県,7,7,2,2,猛暑日,2,5,85
2003,熊本県,90,72,44,31,真夏日,31,41,86
2003,熊本県,17,14,4,2,猛暑日,2,12,86
2003,宮崎県,88,65,46,35,真夏日,35,30,87
2003,宮崎県,15,6,7,3,猛暑日,3,3,87
2003,鹿児島県,117,75,68,35,真夏日,35,40,88
2003,鹿児島県,29,3,16,2,猛暑日,2,1,88
2003,沖縄県,140,100,76,55,真夏日,55,45,91
2003,沖縄県,11,1,9,1,猛暑日,1,0,91
2004,東京都,149,70,78,46,真夏日,46,24,1
2004,東京都,22,6,16,4,猛暑日,4,2,1
2004,北海道,31,14,27,14,真夏日,14,0,24
2004,北海道,4,0,4,0,猛暑日,0,0,24
2004,青森県,36,16,28,14,真夏日,14,2,31
2004,青森県,6,0,6,0,猛暑日,0,0,31
2004,秋田県,37,19,26,17,真夏日,17,2,32
2004,秋田県,8,4,7,4,猛暑日,4,0,32
2004,岩手県,51,23,38,22,真夏日,22,1,33
2004,岩手県,7,0,7,0,猛暑日,0,0,33
2004,宮城県,42,29,30,22,真夏日,22,7,34
2004,宮城県,3,0,3,0,猛暑日,0,0,34
2004,山形県,55,49,40,36,真夏日,36,13,35
2004,山形県,12,9,11,9,猛暑日,9,0,35
2004,福島県,72,63,48,44,真夏日,44,19,36
2004,福島県,10,7,8,6,猛暑日,6,1,36
2004,茨城県,80,55,54,37,真夏日,37,18,40
2004,茨城県,20,3,13,1,猛暑日,1,2,40
2004,栃木県,70,62,50,45,真夏日,45,17,41
2004,栃木県,12,7,8,3,猛暑日,3,4,41
2004,群馬県,78,69,56,48,真夏日,48,21,42
2004,群馬県,25,20,19,16,猛暑日,16,4,42
2004,埼玉県,86,66,58,47,真夏日,47,19,43
2004,埼玉県,32,12,23,8,猛暑日,8,4,43
2004,千葉県,86,68,51,42,真夏日,42,26,45
2004,千葉県,18,3,14,2,猛暑日,2,1,45
2004,神奈川県,72,64,45,41,真夏日,41,23,46
2004,神奈川県,4,3,3,2,猛暑日,2,1,46
2004,長野県,95,55,59,40,真夏日,40,15,48
2004,長野県,22,5,20,4,猛暑日,4,1,48
2004,山梨県,95,86,60,55,真夏日,55,31,49
2004,山梨県,18,17,14,14,猛暑日,14,3,49
2004,静岡県,105,65,62,38,真夏日,38,27,50
2004,静岡県,20,6,15,4,猛暑日,4,2,50
2004,愛知県,96,85,54,49,真夏日,49,36,51
2004,愛知県,22,16,18,13,猛暑日,13,3,51
2004,岐阜県,104,91,62,54,真夏日,54,37,52
2004,岐阜県,27,14,22,11,猛暑日,11,3,52
2004,三重県,92,59,53,39,真夏日,39,20,53
2004,三重県,19,11,15,9,猛暑日,9,2,53
2004,新潟県,69,37,46,24,真夏日,24,13,54
2004,新潟県,18,8,14,8,猛暑日,8,0,54
2004,富山県,67,57,45,39,真夏日,39,18,55
2004,富山県,16,12,10,7,猛暑日,7,5,55
2004,石川県,66,59,42,36,真夏日,36,23,56
2004,石川県,9,8,5,4,猛暑日,4,4,56
2004,福井県,82,70,48,43,真夏日,43,27,57
2004,福井県,12,7,11,6,猛暑日,6,1,57
2004,滋賀県,82,64,50,40,真夏日,40,24,60
2004,滋賀県,6,3,5,2,猛暑日,2,1,60
2004,京都府,102,94,61,57,真夏日,57,37,61
2004,京都府,25,19,23,17,猛暑日,17,2,61
2004,大阪府,103,94,59,51,真夏日,51,43,62
2004,大阪府,26,20,20,15,猛暑日,15,5,62
2004,兵庫県,107,76,63,41,真夏日,41,35,63
2004,兵庫県,27,3,23,3,猛暑日,3,0,63
2004,奈良県,91,76,55,44,真夏日,44,32,64
2004,奈良県,18,9,18,9,猛暑日,9,0,64
2004,和歌山県,96,77,54,42,真夏日,42,35,65
2004,和歌山県,11,3,11,3,猛暑日,3,0,65
2004,岡山県,93,81,55,47,真夏日,47,34,66
2004,岡山県,25,16,21,14,猛暑日,14,2,66
2004,広島県,97,75,56,45,真夏日,45,30,67
2004,広島県,19,5,15,4,猛暑日,4,1,67
2004,島根県,88,55,54,38,真夏日,38,17,68
2004,島根県,16,5,12,4,猛暑日,4,1,68
2004,鳥取県,80,71,51,47,真夏日,47,24,69
2004,鳥取県,12,9,9,7,猛暑日,7,2,69
2004,徳島県,87,67,49,40,真夏日,40,27,71
2004,徳島県,12,4,10,4,猛暑日,4,0,71
2004,香川県,86,77,50,46,真夏日,46,31,72
2004,香川県,18,12,15,10,猛暑日,10,2,72
2004,愛媛県,103,75,59,39,真夏日,39,36,73
2004,愛媛県,23,3,20,3,猛暑日,3,0,73
2004,高知県,100,77,52,40,真夏日,40,37,74
2004,高知県,19,5,15,5,猛暑日,5,0,74
2004,山口県,90,73,53,44,真夏日,44,29,81
2004,山口県,11,7,10,7,猛暑日,7,0,81
2004,福岡県,101,74,62,45,真夏日,45,29,82
2004,福岡県,21,6,12,2,猛暑日,2,4,82
2004,大分県,106,67,66,42,真夏日,42,25,83
2004,大分県,26,5,20,5,猛暑日,5,0,83
2004,長崎県,89,80,49,44,真夏日,44,36,84
2004,長崎県,13,6,8,2,猛暑日,2,4,84
2004,佐賀県,93,89,57,54,真夏日,54,35,85
2004,佐賀県,15,13,9,9,猛暑日,9,4,85
2004,熊本県,113,105,68,63,真夏日,63,42,86
2004,熊本県,31,21,19,12,猛暑日,12,9,86
2004,宮崎県,101,70,60,45,真夏日,45,25,87
2004,宮崎県,23,12,20,12,猛暑日,12,0,87
2004,鹿児島県,122,90,70,49,真夏日,49,41,88
2004,鹿児島県,26,5,16,5,猛暑日,5,0,88
2004,沖縄県,136,102,84,62,真夏日,62,40,91
2004,沖縄県,0,0,0,0,猛暑日,0,0,91
2005,東京都,176,57,92,28,真夏日,28,29,1
2005,東京都,9,4,7,4,猛暑日,4,0,1
2005,北海道,32,9,19,5,真夏日,5,4,24
2005,北海道,1,0,1,0,猛暑日,0,0,24
2005,青森県,36,12,18,8,真夏日,8,4,31
2005,青森県,1,0,1,0,猛暑日,0,0,31
2005,秋田県,46,19,26,9,真夏日,9,10,32
2005,秋田県,2,0,2,0,猛暑日,0,0,32
2005,岩手県,46,19,25,12,真夏日,12,7,33
2005,岩手県,3,1,3,1,猛暑日,1,0,33
2005,宮城県,38,20,24,12,真夏日,12,8,34
2005,宮城県,2,0,2,0,猛暑日,0,0,34
2005,山形県,55,46,30,27,真夏日,27,19,35
2005,山形県,5,4,4,3,猛暑日,3,1,35
2005,福島県,62,47,35,27,真夏日,27,20,36
2005,福島県,6,6,6,6,猛暑日,6,0,36
2005,茨城県,69,45,38,25,真夏日,25,20,40
2005,茨城県,13,1,9,1,猛暑日,1,0,40
2005,栃木県,61,57,32,30,真夏日,30,27,41
2005,栃木県,5,4,5,4,猛暑日,4,0,41
2005,群馬県,74,67,41,38,真夏日,38,29,42
2005,群馬県,15,7,9,7,猛暑日,7,0,42
2005,埼玉県,74,62,42,33,真夏日,33,29,43
2005,埼玉県,16,5,10,4,猛暑日,4,1,43
2005,千葉県,64,48,31,23,真夏日,23,25,45
2005,千葉県,10,2,7,2,猛暑日,2,0,45
2005,神奈川県,62,54,31,26,真夏日,26,28,46
2005,神奈川県,2,2,2,2,猛暑日,2,0,46
2005,長野県,91,49,54,30,真夏日,30,19,48
2005,長野県,15,1,14,1,猛暑日,1,0,48
2005,山梨県,85,80,50,46,真夏日,46,34,49
2005,山梨県,11,9,9,7,猛暑日,7,2,49
2005,静岡県,89,48,47,25,真夏日,25,23,50
2005,静岡県,19,3,13,2,猛暑日,2,1,50
2005,愛知県,88,77,45,38,真夏日,38,39,51
2005,愛知県,21,18,14,11,猛暑日,11,7,51
2005,岐阜県,97,87,52,47,真夏日,47,40,52
2005,岐阜県,22,13,15,9,猛暑日,9,4,52
2005,三重県,91,58,51,32,真夏日,32,26,53
2005,三重県,20,2,11,1,猛暑日,1,1,53
2005,新潟県,68,42,37,20,真夏日,20,22,54
2005,新潟県,8,1,6,1,猛暑日,1,0,54
2005,富山県,60,53,31,28,真夏日,28,25,55
2005,富山県,7,5,4,4,猛暑日,4,1,55
2005,石川県,57,52,27,25,真夏日,25,27,56
2005,石川県,7,2,5,1,猛暑日,1,1,56
2005,福井県,64,55,32,26,真夏日,26,29,57
2005,福井県,6,2,4,2,猛暑日,2,0,57
2005,滋賀県,66,57,36,30,真夏日,30,27,60
2005,滋賀県,4,0,4,0,猛暑日,0,0,60
2005,京都府,95,81,54,47,真夏日,47,34,61
2005,京都府,22,17,15,12,猛暑日,12,5,61
2005,大阪府,102,88,57,50,真夏日,50,38,62
2005,大阪府,23,8,13,7,猛暑日,7,1,62
2005,兵庫県,108,64,64,36,真夏日,36,28,63
2005,兵庫県,26,0,20,0,猛暑日,0,0,63
2005,奈良県,90,69,54,39,真夏日,39,30,64
2005,奈良県,19,5,14,4,猛暑日,4,1,64
2005,和歌山県,90,71,47,37,真夏日,37,34,65
2005,和歌山県,12,1,7,1,猛暑日,1,0,65
2005,岡山県,98,78,61,47,真夏日,47,31,66
2005,岡山県,21,11,16,10,猛暑日,10,1,66
2005,広島県,98,77,59,39,真夏日,39,38,67
2005,広島県,12,2,9,2,猛暑日,2,0,67
2005,島根県,84,62,51,36,真夏日,36,26,68
2005,島根県,7,2,6,1,猛暑日,1,1,68
2005,鳥取県,85,70,50,38,真夏日,38,32,69
2005,鳥取県,14,10,9,6,猛暑日,6,4,69
2005,徳島県,91,69,52,39,真夏日,39,30,71
2005,徳島県,12,1,8,0,猛暑日,0,1,71
2005,香川県,88,78,52,47,真夏日,47,31,72
2005,香川県,11,11,6,6,猛暑日,6,5,72
2005,愛媛県,98,69,53,36,真夏日,36,33,73
2005,愛媛県,19,0,11,0,猛暑日,0,0,73
2005,高知県,105,76,55,39,真夏日,39,37,74
2005,高知県,27,5,17,1,猛暑日,1,4,74
2005,山口県,89,73,51,43,真夏日,43,30,81
2005,山口県,15,3,10,1,猛暑日,1,2,81
2005,福岡県,114,73,67,42,真夏日,42,31,82
2005,福岡県,18,3,11,3,猛暑日,3,0,82
2005,大分県,118,72,72,41,真夏日,41,31,83
2005,大分県,32,7,20,3,猛暑日,3,4,83
2005,長崎県,94,66,48,28,真夏日,28,38,84
2005,長崎県,7,3,6,3,猛暑日,3,0,84
2005,佐賀県,98,89,52,48,真夏日,48,41,85
2005,佐賀県,16,16,11,11,猛暑日,11,5,85
2005,熊本県,112,106,59,54,真夏日,54,52,86
2005,熊本県,21,19,12,10,猛暑日,10,9,86
2005,宮崎県,103,67,54,36,真夏日,36,31,87
2005,宮崎県,22,4,14,2,猛暑日,2,2,87
2005,鹿児島県,130,91,65,43,真夏日,43,48,88
2005,鹿児島県,16,7,11,3,猛暑日,3,4,88
2005,沖縄県,165,109,87,46,真夏日,46,63,91
2005,沖縄県,0,0,0,0,猛暑日,0,0,91
2006,東京都,140,38,76,17,真夏日,17,21,1
2006,東京都,10,3,7,3,猛暑日,3,0,1
2006,北海道,34,14,18,8,真夏日,8,6,24
2006,北海道,0,0,0,0,猛暑日,0,0,24
2006,青森県,31,14,12,8,真夏日,8,6,31
2006,青森県,3,0,1,0,猛暑日,0,0,31
2006,秋田県,39,23,14,6,真夏日,6,17,32
2006,秋田県,6,2,2,0,猛暑日,0,2,32
2006,岩手県,44,19,19,7,真夏日,7,12,33
2006,岩手県,4,1,1,1,猛暑日,1,0,33
2006,宮城県,28,13,13,8,真夏日,8,5,34
2006,宮城県,0,0,0,0,猛暑日,0,0,34
2006,山形県,39,36,17,17,真夏日,17,19,35
2006,山形県,4,0,0,0,猛暑日,0,0,35
2006,福島県,48,37,21,16,真夏日,16,21,36
2006,福島県,5,2,3,2,猛暑日,2,0,36
2006,茨城県,50,23,25,9,真夏日,9,14,40
2006,茨城県,9,1,5,1,猛暑日,1,0,40
2006,栃木県,41,36,18,14,真夏日,14,22,41
2006,栃木県,5,3,4,2,猛暑日,2,1,41
2006,群馬県,57,47,32,24,真夏日,24,23,42
2006,群馬県,11,5,6,4,猛暑日,4,1,42
2006,埼玉県,56,43,31,22,真夏日,22,21,43
2006,埼玉県,11,5,7,5,猛暑日,5,0,43
2006,千葉県,57,40,27,17,真夏日,17,23,45
2006,千葉県,6,2,6,2,猛暑日,2,0,45
2006,神奈川県,53,32,24,15,真夏日,15,17,46
2006,神奈川県,3,2,3,2,猛暑日,2,0,46
2006,長野県,71,46,40,20,真夏日,20,26,48
2006,長野県,18,5,9,0,猛暑日,0,5,48
2006,山梨県,70,63,39,33,真夏日,33,30,49
2006,山梨県,12,12,8,8,猛暑日,8,4,49
2006,静岡県,77,48,42,22,真夏日,22,26,50
2006,静岡県,25,1,15,1,猛暑日,1,0,50
2006,愛知県,76,65,42,35,真夏日,35,30,51
2006,愛知県,21,14,11,8,猛暑日,8,6,51
2006,岐阜県,80,65,46,34,真夏日,34,31,52
2006,岐阜県,29,20,14,11,猛暑日,11,9,52
2006,三重県,76,55,44,29,真夏日,29,26,53
2006,三重県,17,8,12,7,猛暑日,7,1,53
2006,新潟県,51,39,24,15,真夏日,15,24,54
2006,新潟県,10,4,2,0,猛暑日,0,4,54
2006,富山県,45,43,21,20,真夏日,20,23,55
2006,富山県,8,3,1,0,猛暑日,0,3,55
2006,石川県,50,45,22,19,真夏日,19,26,56
2006,石川県,5,1,0,0,猛暑日,0,1,56
2006,福井県,57,53,29,27,真夏日,27,26,57
2006,福井県,10,5,2,1,猛暑日,1,4,57
2006,滋賀県,63,48,34,22,真夏日,22,26,60
2006,滋賀県,11,1,5,1,猛暑日,1,0,60
2006,京都府,76,71,46,41,真夏日,41,30,61
2006,京都府,25,18,9,7,猛暑日,7,11,61
2006,大阪府,78,71,47,41,真夏日,41,30,62
2006,大阪府,27,17,9,7,猛暑日,7,10,62
2006,兵庫県,82,54,51,25,真夏日,25,29,63
2006,兵庫県,24,5,11,2,猛暑日,2,3,63
2006,奈良県,66,61,38,33,真夏日,33,28,64
2006,奈良県,15,12,6,3,猛暑日,3,9,64
2006,和歌山県,72,59,39,31,真夏日,31,28,65
2006,和歌山県,21,11,9,4,猛暑日,4,7,65
2006,岡山県,76,67,49,41,真夏日,41,26,66
2006,岡山県,23,14,14,10,猛暑日,10,4,66
2006,広島県,78,56,47,28,真夏日,28,28,67
2006,広島県,21,7,9,5,猛暑日,5,2,67
2006,島根県,65,47,37,23,真夏日,23,24,68
2006,島根県,14,3,9,0,猛暑日,0,3,68
2006,鳥取県,62,56,33,27,真夏日,27,29,69
2006,鳥取県,16,9,4,2,猛暑日,2,7,69
2006,徳島県,65,49,35,23,真夏日,23,26,71
2006,徳島県,9,4,6,3,猛暑日,3,1,71
2006,香川県,66,63,41,38,真夏日,38,25,72
2006,香川県,19,14,11,9,猛暑日,9,5,72
2006,愛媛県,79,63,47,32,真夏日,32,31,73
2006,愛媛県,26,4,15,2,猛暑日,2,2,73
2006,高知県,82,63,45,32,真夏日,32,31,74
2006,高知県,21,3,13,2,猛暑日,2,1,74
2006,山口県,71,58,44,33,真夏日,33,25,81
2006,山口県,16,11,8,5,猛暑日,5,6,81
2006,福岡県,79,55,50,33,真夏日,33,22,82
2006,福岡県,25,6,15,4,猛暑日,4,2,82
2006,大分県,80,51,50,29,真夏日,29,22,83
2006,大分県,31,2,20,2,猛暑日,2,0,83
2006,長崎県,65,50,35,27,真夏日,27,23,84
2006,長崎県,14,2,10,1,猛暑日,1,1,84
2006,佐賀県,70,68,41,40,真夏日,40,28,85
2006,佐賀県,23,23,13,13,猛暑日,13,10,85
2006,熊本県,93,78,49,42,真夏日,42,36,86
2006,熊本県,28,22,18,13,猛暑日,13,9,86
2006,宮崎県,97,63,57,38,真夏日,38,25,87
2006,宮崎県,22,3,14,3,猛暑日,3,0,87
2006,鹿児島県,112,76,58,42,真夏日,42,34,88
2006,鹿児島県,25,8,17,5,猛暑日,5,3,88
2006,沖縄県,159,96,83,53,真夏日,53,43,91
2006,沖縄県,2,1,2,1,猛暑日,1,0,91
2007,東京都,169,55,83,25,真夏日,25,30,1
2007,東京都,14,7,4,0,猛暑日,0,7,1
2007,北海道,31,10,18,2,真夏日,2,8,24
2007,北海道,4,0,0,0,猛暑日,0,0,24
2007,青森県,32,21,17,8,真夏日,8,13,31
2007,青森県,4,0,0,0,猛暑日,0,0,31
2007,秋田県,39,15,18,5,真夏日,5,10,32
2007,秋田県,6,2,2,1,猛暑日,1,1,32
2007,岩手県,42,22,20,12,真夏日,12,10,33
2007,岩手県,6,2,1,0,猛暑日,0,2,33
2007,宮城県,42,22,18,10,真夏日,10,12,34
2007,宮城県,4,1,1,0,猛暑日,0,1,34
2007,山形県,45,42,19,18,真夏日,18,24,35
2007,山形県,8,7,3,3,猛暑日,3,4,35
2007,福島県,56,47,24,22,真夏日,22,25,36
2007,福島県,13,10,4,3,猛暑日,3,7,36
2007,茨城県,63,38,30,11,真夏日,11,27,40
2007,茨城県,17,4,4,0,猛暑日,0,4,40
2007,栃木県,56,51,25,21,真夏日,21,30,41
2007,栃木県,9,6,0,0,猛暑日,0,6,41
2007,群馬県,71,61,37,29,真夏日,29,32,42
2007,群馬県,24,13,9,3,猛暑日,3,10,42
2007,埼玉県,72,54,39,24,真夏日,24,30,43
2007,埼玉県,21,8,6,1,猛暑日,1,7,43
2007,千葉県,68,51,30,21,真夏日,21,30,45
2007,千葉県,9,5,0,0,猛暑日,0,5,45
2007,神奈川県,56,46,26,18,真夏日,18,28,46
2007,神奈川県,7,3,0,0,猛暑日,0,3,46
2007,長野県,75,54,37,21,真夏日,21,33,48
2007,長野県,14,4,1,0,猛暑日,0,4,48
2007,山梨県,76,74,42,41,真夏日,41,33,49
2007,山梨県,16,14,2,2,猛暑日,2,12,49
2007,静岡県,82,49,40,22,真夏日,22,27,50
2007,静岡県,18,2,4,0,猛暑日,0,2,50
2007,愛知県,83,73,39,34,真夏日,34,39,51
2007,愛知県,17,14,4,1,猛暑日,1,13,51
2007,岐阜県,88,73,46,35,真夏日,35,38,52
2007,岐阜県,26,19,8,4,猛暑日,4,15,52
2007,三重県,79,52,37,21,真夏日,21,31,53
2007,三重県,15,4,2,0,猛暑日,0,4,53
2007,新潟県,56,29,20,8,真夏日,8,21,54
2007,新潟県,10,2,2,2,猛暑日,2,0,54
2007,富山県,49,46,16,16,真夏日,16,30,55
2007,富山県,18,16,5,5,猛暑日,5,11,55
2007,石川県,45,38,14,10,真夏日,10,28,56
2007,石川県,8,4,4,3,猛暑日,3,1,56
2007,福井県,59,48,22,15,真夏日,15,33,57
2007,福井県,9,7,3,1,猛暑日,1,6,57
2007,滋賀県,62,46,23,14,真夏日,14,32,60
2007,滋賀県,10,3,1,1,猛暑日,1,2,60
2007,京都府,81,76,39,34,真夏日,34,42,61
2007,京都府,24,20,7,5,猛暑日,5,15,61
2007,大阪府,83,79,35,31,真夏日,31,48,62
2007,大阪府,21,16,1,0,猛暑日,0,16,62
2007,兵庫県,90,62,42,17,真夏日,17,45,63
2007,兵庫県,21,2,6,0,猛暑日,0,2,63
2007,奈良県,76,65,35,26,真夏日,26,39,64
2007,奈良県,12,11,1,0,猛暑日,0,11,64
2007,和歌山県,83,68,37,23,真夏日,23,45,65
2007,和歌山県,15,4,1,0,猛暑日,0,4,65
2007,岡山県,87,76,41,33,真夏日,33,43,66
2007,岡山県,19,14,4,3,猛暑日,3,11,66
2007,広島県,87,75,39,27,真夏日,27,48,67
2007,広島県,15,8,1,0,猛暑日,0,8,67
2007,島根県,72,49,31,18,真夏日,18,31,68
2007,島根県,19,6,5,0,猛暑日,0,6,68
2007,鳥取県,65,55,30,21,真夏日,21,34,69
2007,鳥取県,18,9,4,2,猛暑日,2,7,69
2007,徳島県,85,68,38,23,真夏日,23,45,71
2007,徳島県,9,5,2,0,猛暑日,0,5,71
2007,香川県,80,78,31,30,真夏日,30,48,72
2007,香川県,18,12,2,2,猛暑日,2,10,72
2007,愛媛県,96,76,46,29,真夏日,29,47,73
2007,愛媛県,24,2,5,0,猛暑日,0,2,73
2007,高知県,91,77,40,31,真夏日,31,46,74
2007,高知県,21,4,6,1,猛暑日,1,3,74
2007,山口県,81,70,35,27,真夏日,27,43,81
2007,山口県,11,8,2,2,猛暑日,2,6,81
2007,福岡県,101,74,47,30,真夏日,30,44,82
2007,福岡県,25,8,7,2,猛暑日,2,6,82
2007,大分県,104,74,49,32,真夏日,32,42,83
2007,大分県,35,6,12,1,猛暑日,1,5,83
2007,長崎県,93,75,35,24,真夏日,24,51,84
2007,長崎県,11,0,1,0,猛暑日,0,0,84
2007,佐賀県,91,87,40,37,真夏日,37,50,85
2007,佐賀県,20,16,7,6,猛暑日,6,10,85
2007,熊本県,106,99,46,41,真夏日,41,58,86
2007,熊本県,33,27,10,10,猛暑日,10,17,86
2007,宮崎県,107,77,50,36,真夏日,36,41,87
2007,宮崎県,23,1,13,1,猛暑日,1,0,87
2007,鹿児島県,122,96,60,39,真夏日,39,57,88
2007,鹿児島県,19,13,12,10,猛暑日,10,3,88
2007,沖縄県,151,110,78,55,真夏日,55,55,91
2007,沖縄県,2,0,2,0,猛暑日,0,0,91
2008,東京都,168,53,96,32,真夏日,32,21,1
2008,東京都,14,1,11,1,猛暑日,1,0,1
2008,北海道,31,4,23,4,真夏日,4,0,24
2008,北海道,0,0,0,0,猛暑日,0,0,24
2008,青森県,17,4,11,4,真夏日,4,0,31
2008,青森県,0,0,0,0,猛暑日,0,0,31
2008,秋田県,39,19,22,10,真夏日,10,9,32
2008,秋田県,0,0,0,0,猛暑日,0,0,32
2008,岩手県,34,13,22,11,真夏日,11,2,33
2008,岩手県,1,0,1,0,猛暑日,0,0,33
2008,宮城県,24,11,19,8,真夏日,8,3,34
2008,宮城県,0,0,0,0,猛暑日,0,0,34
2008,山形県,49,40,31,29,真夏日,29,11,35
2008,山形県,2,2,2,2,猛暑日,2,0,35
2008,福島県,56,38,37,27,真夏日,27,11,36
2008,福島県,3,3,3,3,猛暑日,3,0,36
2008,茨城県,65,24,41,16,真夏日,16,8,40
2008,茨城県,11,2,8,1,猛暑日,1,1,40
2008,栃木県,54,48,31,27,真夏日,27,21,41
2008,栃木県,5,2,3,2,猛暑日,2,0,41
2008,群馬県,68,58,41,35,真夏日,35,23,42
2008,群馬県,16,11,12,9,猛暑日,9,2,42
2008,埼玉県,65,49,38,31,真夏日,31,18,43
2008,埼玉県,14,4,10,3,猛暑日,3,1,43
2008,千葉県,60,48,32,28,真夏日,28,20,45
2008,千葉県,12,1,7,1,猛暑日,1,0,45
2008,神奈川県,60,51,35,31,真夏日,31,20,46
2008,神奈川県,11,1,7,0,猛暑日,0,1,46
2008,長野県,76,47,45,31,真夏日,31,16,48
2008,長野県,19,3,17,3,猛暑日,3,0,48
2008,山梨県,70,64,38,35,真夏日,35,29,49
2008,山梨県,14,13,12,11,猛暑日,11,2,49
2008,静岡県,78,53,40,26,真夏日,26,27,50
2008,静岡県,29,4,21,0,猛暑日,0,4,50
2008,愛知県,76,69,39,37,真夏日,37,32,51
2008,愛知県,33,26,25,19,猛暑日,19,7,51
2008,岐阜県,90,73,54,42,真夏日,42,31,52
2008,岐阜県,36,21,27,16,猛暑日,16,5,52
2008,三重県,74,53,42,33,真夏日,33,20,53
2008,三重県,23,5,15,3,猛暑日,3,2,53
2008,新潟県,65,24,37,13,真夏日,13,11,54
2008,新潟県,6,0,3,0,猛暑日,0,0,54
2008,富山県,50,44,33,31,真夏日,31,13,55
2008,富山県,6,4,5,4,猛暑日,4,0,55
2008,石川県,58,50,39,33,真夏日,33,17,56
2008,石川県,4,2,4,2,猛暑日,2,0,56
2008,福井県,63,56,40,38,真夏日,38,18,57
2008,福井県,13,9,9,6,猛暑日,6,3,57
2008,滋賀県,65,53,40,34,真夏日,34,19,60
2008,滋賀県,16,6,10,3,猛暑日,3,3,60
2008,京都府,82,78,48,45,真夏日,45,33,61
2008,京都府,28,21,21,16,猛暑日,16,5,61
2008,大阪府,84,71,47,40,真夏日,40,31,62
2008,大阪府,24,13,18,10,猛暑日,10,3,62
2008,兵庫県,86,60,48,33,真夏日,33,27,63
2008,兵庫県,28,0,20,0,猛暑日,0,0,63
2008,奈良県,73,65,42,38,真夏日,38,27,64
2008,奈良県,24,11,17,7,猛暑日,7,4,64
2008,和歌山県,81,64,41,32,真夏日,32,32,65
2008,和歌山県,19,4,10,4,猛暑日,4,0,65
2008,岡山県,86,71,52,43,真夏日,43,28,66
2008,岡山県,30,19,24,15,猛暑日,15,4,66
2008,広島県,85,73,45,39,真夏日,39,34,67
2008,広島県,23,13,18,10,猛暑日,10,3,67
2008,島根県,74,53,47,36,真夏日,36,17,68
2008,島根県,19,8,13,3,猛暑日,3,5,68
2008,鳥取県,64,61,41,39,真夏日,39,22,69
2008,鳥取県,16,15,11,10,猛暑日,10,5,69
2008,徳島県,80,66,44,36,真夏日,36,30,71
2008,徳島県,19,4,13,3,猛暑日,3,1,71
2008,香川県,77,70,43,41,真夏日,41,29,72
2008,香川県,30,15,23,14,猛暑日,14,1,72
2008,愛媛県,86,73,46,39,真夏日,39,34,73
2008,愛媛県,29,11,23,8,猛暑日,8,3,73
2008,高知県,86,72,45,39,真夏日,39,33,74
2008,高知県,16,2,14,2,猛暑日,2,0,74
2008,山口県,78,68,42,38,真夏日,38,30,81
2008,山口県,20,11,16,10,猛暑日,10,1,81
2008,福岡県,82,65,45,40,真夏日,40,25,82
2008,福岡県,28,10,23,7,猛暑日,7,3,82
2008,大分県,89,66,48,40,真夏日,40,26,83
2008,大分県,37,11,30,9,猛暑日,9,2,83
2008,長崎県,79,69,41,37,真夏日,37,32,84
2008,長崎県,13,3,8,2,猛暑日,2,1,84
2008,佐賀県,82,76,43,42,真夏日,42,34,85
2008,佐賀県,23,21,19,17,猛暑日,17,4,85
2008,熊本県,94,87,50,47,真夏日,47,40,86
2008,熊本県,28,22,23,17,猛暑日,17,5,86
2008,宮崎県,96,58,56,36,真夏日,36,22,87
2008,宮崎県,26,7,22,6,猛暑日,6,1,87
2008,鹿児島県,122,77,66,39,真夏日,39,38,88
2008,鹿児島県,17,10,16,9,猛暑日,9,1,88
2008,沖縄県,160,124,74,62,真夏日,62,62,91
2008,沖縄県,0,0,0,0,猛暑日,0,0,91
2009,東京都,160,38,79,22,真夏日,22,16,1
2009,東京都,2,0,2,0,猛暑日,0,0,1
2009,北海道,21,4,16,1,真夏日,1,3,24
2009,北海道,0,0,0,0,猛暑日,0,0,24
2009,青森県,13,4,9,2,真夏日,2,2,31
2009,青森県,0,0,0,0,猛暑日,0,0,31
2009,秋田県,29,10,21,7,真夏日,7,3,32
2009,秋田県,0,0,0,0,猛暑日,0,0,32
2009,岩手県,30,15,23,12,真夏日,12,3,33
2009,岩手県,0,0,0,0,猛暑日,0,0,33
2009,宮城県,22,10,18,9,真夏日,9,1,34
2009,宮城県,0,0,0,0,猛暑日,0,0,34
2009,山形県,33,25,23,18,真夏日,18,7,35
2009,山形県,1,1,1,1,猛暑日,1,0,35
2009,福島県,49,37,33,25,真夏日,25,12,36
2009,福島県,5,3,5,3,猛暑日,3,0,36
2009,茨城県,55,21,30,15,真夏日,15,6,40
2009,茨城県,4,0,4,0,猛暑日,0,0,40
2009,栃木県,48,42,27,25,真夏日,25,17,41
2009,栃木県,2,1,2,1,猛暑日,1,0,41
2009,群馬県,64,50,35,29,真夏日,29,21,42
2009,群馬県,7,3,5,3,猛暑日,3,0,42
2009,埼玉県,58,43,33,25,真夏日,25,18,43
2009,埼玉県,4,1,3,1,猛暑日,1,0,43
2009,千葉県,48,29,31,17,真夏日,17,12,45
2009,千葉県,2,0,0,0,猛暑日,0,0,45
2009,神奈川県,50,30,26,15,真夏日,15,15,46
2009,神奈川県,0,0,0,0,猛暑日,0,0,46
2009,長野県,67,38,39,24,真夏日,24,14,48
2009,長野県,3,1,2,1,猛暑日,1,0,48
2009,山梨県,75,63,42,36,真夏日,36,27,49
2009,山梨県,10,3,7,2,猛暑日,2,1,49
2009,静岡県,72,37,38,19,真夏日,19,18,50
2009,静岡県,6,2,4,1,猛暑日,1,1,50
2009,愛知県,77,72,39,36,真夏日,36,36,51
2009,愛知県,7,2,3,1,猛暑日,1,1,51
2009,岐阜県,87,69,48,39,真夏日,39,30,52
2009,岐阜県,11,7,5,3,猛暑日,3,4,52
2009,三重県,81,42,46,21,真夏日,21,21,53
2009,三重県,10,2,4,2,猛暑日,2,0,53
2009,新潟県,48,17,32,11,真夏日,11,6,54
2009,新潟県,2,1,2,1,猛暑日,1,0,54
2009,富山県,41,32,28,21,真夏日,21,11,55
2009,富山県,2,2,1,1,猛暑日,1,1,55
2009,石川県,40,27,27,17,真夏日,17,10,56
2009,石川県,1,0,1,0,猛暑日,0,0,56
2009,福井県,54,40,34,27,真夏日,27,13,57
2009,福井県,2,1,1,0,猛暑日,0,1,57
2009,滋賀県,67,37,42,23,真夏日,23,14,60
2009,滋賀県,4,1,3,1,猛暑日,1,0,60
2009,京都府,89,69,56,41,真夏日,41,28,61
2009,京都府,9,6,4,3,猛暑日,3,3,61
2009,大阪府,86,73,50,39,真夏日,39,34,62
2009,大阪府,9,3,6,1,猛暑日,1,2,62
2009,兵庫県,91,48,56,22,真夏日,22,26,63
2009,兵庫県,7,2,4,1,猛暑日,1,1,63
2009,奈良県,80,73,48,41,真夏日,41,32,64
2009,奈良県,3,1,2,0,猛暑日,0,1,64
2009,和歌山県,84,59,44,29,真夏日,29,30,65
2009,和歌山県,3,0,1,0,猛暑日,0,0,65
2009,岡山県,82,69,50,43,真夏日,43,26,66
2009,岡山県,2,1,2,1,猛暑日,1,0,66
2009,広島県,85,60,49,29,真夏日,29,31,67
2009,広島県,4,1,3,1,猛暑日,1,0,67
2009,島根県,64,30,37,18,真夏日,18,12,68
2009,島根県,4,0,3,0,猛暑日,0,0,68
2009,鳥取県,48,42,31,27,真夏日,27,15,69
2009,鳥取県,1,0,0,0,猛暑日,0,0,69
2009,徳島県,80,57,44,29,真夏日,29,28,71
2009,徳島県,6,2,3,1,猛暑日,1,1,71
2009,香川県,79,71,47,43,真夏日,43,28,72
2009,香川県,4,4,3,3,猛暑日,3,1,72
2009,愛媛県,99,66,55,32,真夏日,32,34,73
2009,愛媛県,12,1,7,1,猛暑日,1,0,73
2009,高知県,102,62,54,29,真夏日,29,33,74
2009,高知県,6,4,1,0,猛暑日,0,4,74
2009,山口県,79,68,46,38,真夏日,38,30,81
2009,山口県,1,0,1,0,猛暑日,0,0,81
2009,福岡県,92,57,52,31,真夏日,31,26,82
2009,福岡県,7,0,5,0,猛暑日,0,0,82
2009,大分県,102,58,62,31,真夏日,31,27,83
2009,大分県,16,2,7,1,猛暑日,1,1,83
2009,長崎県,81,57,39,19,真夏日,19,38,84
2009,長崎県,7,2,5,2,猛暑日,2,0,84
2009,佐賀県,79,71,41,35,真夏日,35,36,85
2009,佐賀県,6,5,3,3,猛暑日,3,2,85
2009,熊本県,102,83,54,38,真夏日,38,45,86
2009,熊本県,19,9,8,3,猛暑日,3,6,86
2009,宮崎県,110,58,61,33,真夏日,33,25,87
2009,宮崎県,20,4,9,3,猛暑日,3,1,87
2009,鹿児島県,119,89,64,39,真夏日,39,50,88
2009,鹿児島県,9,6,3,2,猛暑日,2,4,88
2009,沖縄県,137,109,74,52,真夏日,52,57,91
2009,沖縄県,6,0,4,0,猛暑日,0,0,91
2010,東京都,146,71,71,35,真夏日,35,36,1
2010,東京都,37,13,15,4,猛暑日,4,9,1
2010,北海道,46,20,28,9,真夏日,9,11,24
2010,北海道,3,0,3,0,猛暑日,0,0,24
2010,青森県,46,33,22,14,真夏日,14,19,31
2010,青森県,3,1,2,1,猛暑日,1,0,31
2010,秋田県,62,36,34,14,真夏日,14,22,32
2010,秋田県,3,1,2,1,猛暑日,1,0,32
2010,岩手県,68,50,41,28,真夏日,28,22,33
2010,岩手県,13,2,8,2,猛暑日,2,0,33
2010,宮城県,63,48,35,24,真夏日,24,24,34
2010,宮城県,12,2,7,1,猛暑日,1,1,34
2010,山形県,73,67,42,38,真夏日,38,29,35
2010,山形県,12,8,6,5,猛暑日,5,3,35
2010,福島県,83,72,49,42,真夏日,42,30,36
2010,福島県,30,24,13,12,猛暑日,12,12,36
2010,茨城県,87,58,49,28,真夏日,28,30,40
2010,茨城県,37,6,16,1,猛暑日,1,5,40
2010,栃木県,76,67,39,33,真夏日,33,34,41
2010,栃木県,28,11,9,4,猛暑日,4,7,41
2010,群馬県,93,82,54,46,真夏日,46,36,42
2010,群馬県,42,27,18,9,猛暑日,9,18,42
2010,埼玉県,93,82,53,44,真夏日,44,38,43
2010,埼玉県,43,33,18,12,猛暑日,12,21,43
2010,千葉県,85,67,45,31,真夏日,31,36,45
2010,千葉県,32,10,10,4,猛暑日,4,6,45
2010,神奈川県,79,68,42,33,真夏日,33,35,46
2010,神奈川県,19,6,7,2,猛暑日,2,4,46
2010,長野県,88,62,49,32,真夏日,32,30,48
2010,長野県,32,4,13,2,猛暑日,2,2,48
2010,山梨県,90,82,49,44,真夏日,44,38,49
2010,山梨県,39,34,13,11,猛暑日,11,23,49
2010,静岡県,87,68,46,33,真夏日,33,35,50
2010,静岡県,30,3,11,0,猛暑日,0,3,50
2010,愛知県,90,83,47,43,真夏日,43,40,51
2010,愛知県,38,30,13,10,猛暑日,10,20,51
2010,岐阜県,92,81,51,42,真夏日,42,39,52
2010,岐阜県,41,33,17,11,猛暑日,11,22,52
2010,三重県,92,71,50,34,真夏日,34,37,53
2010,三重県,35,13,12,7,猛暑日,7,6,53
2010,新潟県,78,54,44,27,真夏日,27,27,54
2010,新潟県,23,3,7,1,猛暑日,1,2,54
2010,富山県,72,66,37,32,真夏日,32,34,55
2010,富山県,28,19,14,9,猛暑日,9,10,55
2010,石川県,67,60,35,30,真夏日,30,30,56
2010,石川県,16,3,6,1,猛暑日,1,2,56
2010,福井県,77,69,41,36,真夏日,36,33,57
2010,福井県,34,25,14,9,猛暑日,9,16,57
2010,滋賀県,80,67,41,33,真夏日,33,34,60
2010,滋賀県,37,11,14,3,猛暑日,3,8,60
2010,京都府,91,85,50,46,真夏日,46,39,61
2010,京都府,46,35,18,14,猛暑日,14,21,61
2010,大阪府,94,82,49,41,真夏日,41,41,62
2010,大阪府,40,31,13,9,猛暑日,9,22,62
2010,兵庫県,96,72,53,32,真夏日,32,40,63
2010,兵庫県,47,7,19,2,猛暑日,2,5,63
2010,奈良県,87,83,46,43,真夏日,43,40,64
2010,奈良県,31,30,8,7,猛暑日,7,23,64
2010,和歌山県,87,75,44,33,真夏日,33,42,65
2010,和歌山県,32,10,10,5,猛暑日,5,5,65
2010,岡山県,91,88,48,46,真夏日,46,42,66
2010,岡山県,36,24,12,8,猛暑日,8,16,66
2010,広島県,92,79,49,36,真夏日,36,43,67
2010,広島県,41,24,14,6,猛暑日,6,18,67
2010,島根県,82,64,44,29,真夏日,29,35,68
2010,島根県,40,18,16,7,猛暑日,7,11,68
2010,鳥取県,78,70,41,35,真夏日,35,35,69
2010,鳥取県,42,30,17,9,猛暑日,9,21,69
2010,徳島県,85,72,41,29,真夏日,29,43,71
2010,徳島県,18,6,5,2,猛暑日,2,4,71
2010,香川県,92,86,49,43,真夏日,43,43,72
2010,香川県,37,22,10,6,猛暑日,6,16,72
2010,愛媛県,93,76,50,34,真夏日,34,42,73
2010,愛媛県,40,14,11,3,猛暑日,3,11,73
2010,高知県,91,76,44,32,真夏日,32,44,74
2010,高知県,21,3,7,1,猛暑日,1,2,74
2010,山口県,87,80,44,40,真夏日,40,40,81
2010,山口県,31,13,11,5,猛暑日,5,8,81
2010,福岡県,90,74,48,33,真夏日,33,41,82
2010,福岡県,39,24,16,7,猛暑日,7,17,82
2010,大分県,98,75,55,35,真夏日,35,40,83
2010,大分県,48,20,18,4,猛暑日,4,16,83
2010,長崎県,77,60,36,23,真夏日,23,37,84
2010,長崎県,18,1,7,1,猛暑日,1,0,84
2010,佐賀県,79,77,40,38,真夏日,38,39,85
2010,佐賀県,28,26,12,10,猛暑日,10,16,85
2010,熊本県,94,85,50,43,真夏日,43,42,86
2010,熊本県,27,23,10,7,猛暑日,7,16,86
2010,宮崎県,93,73,48,34,真夏日,34,39,87
2010,宮崎県,14,4,4,2,猛暑日,2,2,87
2010,鹿児島県,116,75,60,31,真夏日,31,44,88
2010,鹿児島県,11,0,3,0,猛暑日,0,0,88
2010,沖縄県,142,97,71,46,真夏日,46,51,91
2010,沖縄県,4,0,4,0,猛暑日,0,0,91
2011,東京都,137,61,78,32,真夏日,32,29,1
2011,東京都,26,4,17,1,猛暑日,1,3,1
2011,北海道,39,11,27,7,真夏日,7,4,24
2011,北海道,0,0,0,0,猛暑日,0,0,24
2011,青森県,38,23,23,11,真夏日,11,12,31
2011,青森県,3,1,0,0,猛暑日,0,1,31
2011,秋田県,57,34,33,21,真夏日,21,13,32
2011,秋田県,4,1,3,1,猛暑日,1,0,32
2011,岩手県,54,27,37,19,真夏日,19,8,33
2011,岩手県,8,0,6,0,猛暑日,0,0,33
2011,宮城県,48,36,30,22,真夏日,22,14,34
2011,宮城県,6,1,2,0,猛暑日,0,1,34
2011,山形県,68,53,37,31,真夏日,31,22,35
2011,山形県,6,4,3,2,猛暑日,2,2,35
2011,福島県,79,69,49,41,真夏日,41,28,36
2011,福島県,18,14,12,9,猛暑日,9,5,36
2011,茨城県,76,47,41,28,真夏日,28,19,40
2011,茨城県,27,6,18,3,猛暑日,3,3,40
2011,栃木県,73,63,41,35,真夏日,35,28,41
2011,栃木県,24,12,15,9,猛暑日,9,3,41
2011,群馬県,80,69,46,42,真夏日,42,27,42
2011,群馬県,30,23,19,16,猛暑日,16,7,42
2011,埼玉県,79,69,46,37,真夏日,37,32,43
2011,埼玉県,28,18,19,10,猛暑日,10,8,43
2011,千葉県,75,61,38,29,真夏日,29,32,45
2011,千葉県,23,2,11,1,猛暑日,1,1,45
2011,神奈川県,70,64,36,33,真夏日,33,31,46
2011,神奈川県,9,1,3,0,猛暑日,0,1,46
2011,長野県,81,63,50,36,真夏日,36,27,48
2011,長野県,14,4,10,2,猛暑日,2,2,48
2011,山梨県,80,75,48,45,真夏日,45,30,49
2011,山梨県,27,26,19,18,猛暑日,18,8,49
2011,静岡県,87,65,47,38,真夏日,38,27,50
2011,静岡県,19,8,11,4,猛暑日,4,4,50
2011,愛知県,82,78,47,44,真夏日,44,34,51
2011,愛知県,20,14,13,8,猛暑日,8,6,51
2011,岐阜県,85,79,49,44,真夏日,44,35,52
2011,岐阜県,28,15,17,10,猛暑日,10,5,52
2011,三重県,86,61,49,36,真夏日,36,25,53
2011,三重県,20,4,13,1,猛暑日,1,3,53
2011,新潟県,79,51,47,26,真夏日,26,25,54
2011,新潟県,21,2,13,1,猛暑日,1,1,54
2011,富山県,66,58,44,37,真夏日,37,21,55
2011,富山県,11,5,6,2,猛暑日,2,3,55
2011,石川県,68,65,39,37,真夏日,37,28,56
2011,石川県,6,2,4,2,猛暑日,2,0,56
2011,福井県,83,75,49,43,真夏日,43,32,57
2011,福井県,24,12,17,10,猛暑日,10,2,57
2011,滋賀県,80,77,45,44,真夏日,44,33,60
2011,滋賀県,19,10,14,5,猛暑日,5,5,60
2011,京都府,85,79,49,44,真夏日,44,35,61
2011,京都府,32,17,22,10,猛暑日,10,7,61
2011,大阪府,82,76,43,43,真夏日,43,33,62
2011,大阪府,27,7,14,4,猛暑日,4,3,62
2011,兵庫県,89,66,53,34,真夏日,34,32,63
2011,兵庫県,30,2,20,1,猛暑日,1,1,63
2011,奈良県,74,72,43,41,真夏日,41,31,64
2011,奈良県,13,7,7,2,猛暑日,2,5,64
2011,和歌山県,78,70,43,38,真夏日,38,32,65
2011,和歌山県,10,3,4,0,猛暑日,0,3,65
2011,岡山県,78,69,45,40,真夏日,40,29,66
2011,岡山県,14,11,7,5,猛暑日,5,6,66
2011,広島県,84,70,50,39,真夏日,39,31,67
2011,広島県,12,1,9,0,猛暑日,0,1,67
2011,島根県,77,59,47,32,真夏日,32,27,68
2011,島根県,11,2,9,2,猛暑日,2,0,68
2011,鳥取県,71,65,42,36,真夏日,36,29,69
2011,鳥取県,18,13,15,10,猛暑日,10,3,69
2011,徳島県,80,68,44,39,真夏日,39,29,71
2011,徳島県,4,1,2,0,猛暑日,0,1,71
2011,香川県,80,72,46,41,真夏日,41,31,72
2011,香川県,13,7,7,2,猛暑日,2,5,72
2011,愛媛県,86,71,49,41,真夏日,41,30,73
2011,愛媛県,16,3,7,2,猛暑日,2,1,73
2011,高知県,86,73,48,38,真夏日,38,35,74
2011,高知県,6,0,1,0,猛暑日,0,0,74
2011,山口県,84,68,49,40,真夏日,40,28,81
2011,山口県,6,3,3,1,猛暑日,1,2,81
2011,福岡県,86,73,49,42,真夏日,42,31,82
2011,福岡県,24,8,15,6,猛暑日,6,2,82
2011,大分県,97,70,59,40,真夏日,40,30,83
2011,大分県,23,3,12,1,猛暑日,1,2,83
2011,長崎県,84,64,46,37,真夏日,37,27,84
2011,長崎県,8,2,6,2,猛暑日,2,0,84
2011,佐賀県,77,74,43,41,真夏日,41,33,85
2011,佐賀県,11,10,8,7,猛暑日,7,3,85
2011,熊本県,92,82,51,45,真夏日,45,37,86
2011,熊本県,17,8,10,3,猛暑日,3,5,86
2011,宮崎県,93,68,54,40,真夏日,40,28,87
2011,宮崎県,12,0,5,0,猛暑日,0,0,87
2011,鹿児島県,119,79,70,42,真夏日,42,37,88
2011,鹿児島県,9,1,2,0,猛暑日,0,1,88
2011,沖縄県,141,105,75,59,真夏日,59,46,91
2011,沖縄県,2,0,1,0,猛暑日,0,0,91
2012,東京都,141,66,76,25,真夏日,25,41,1
2012,東京都,25,6,12,2,猛暑日,2,4,1
2012,北海道,47,20,18,8,真夏日,8,12,24
2012,北海道,1,0,0,0,猛暑日,0,0,24
2012,青森県,45,30,11,7,真夏日,7,23,31
2012,青森県,8,2,3,1,猛暑日,1,1,31
2012,秋田県,58,38,23,10,真夏日,10,28,32
2012,秋田県,12,3,4,0,猛暑日,0,3,32
2012,岩手県,66,49,25,16,真夏日,16,33,33
2012,岩手県,13,5,6,2,猛暑日,2,3,33
2012,宮城県,60,46,21,13,真夏日,13,33,34
2012,宮城県,4,0,1,0,猛暑日,0,0,34
2012,山形県,67,62,27,23,真夏日,23,39,35
2012,山形県,24,16,10,10,猛暑日,10,6,35
2012,福島県,75,64,32,25,真夏日,25,39,36
2012,福島県,25,18,12,6,猛暑日,6,12,36
2012,茨城県,78,56,34,23,真夏日,23,33,40
2012,茨城県,24,3,11,2,猛暑日,2,1,40
2012,栃木県,77,69,33,27,真夏日,27,42,41
2012,栃木県,28,5,13,4,猛暑日,4,1,41
2012,群馬県,83,74,38,32,真夏日,32,42,42
2012,群馬県,35,22,16,10,猛暑日,10,12,42
2012,埼玉県,78,70,33,28,真夏日,28,42,43
2012,埼玉県,34,19,15,9,猛暑日,9,10,43
2012,千葉県,75,58,31,22,真夏日,22,36,45
2012,千葉県,10,1,4,0,猛暑日,0,1,45
2012,神奈川県,67,60,26,21,真夏日,21,39,46
2012,神奈川県,3,0,1,0,猛暑日,0,0,46
2012,長野県,83,59,42,24,真夏日,24,35,48
2012,長野県,19,4,16,4,猛暑日,4,0,48
2012,山梨県,85,82,39,38,真夏日,38,44,49
2012,山梨県,27,21,14,11,猛暑日,11,10,49
2012,静岡県,82,62,35,25,真夏日,25,37,50
2012,静岡県,10,1,9,1,猛暑日,1,0,50
2012,愛知県,79,76,35,35,真夏日,35,41,51
2012,愛知県,14,12,11,9,猛暑日,9,3,51
2012,岐阜県,95,73,44,33,真夏日,33,40,52
2012,岐阜県,27,12,16,11,猛暑日,11,1,52
2012,三重県,78,59,36,27,真夏日,27,32,53
2012,三重県,8,4,7,4,猛暑日,4,0,53
2012,新潟県,75,48,36,16,真夏日,16,32,54
2012,新潟県,33,5,10,0,猛暑日,0,5,54
2012,富山県,64,61,28,27,真夏日,27,34,55
2012,富山県,16,12,7,4,猛暑日,4,8,55
2012,石川県,65,62,29,27,真夏日,27,35,56
2012,石川県,11,6,4,1,猛暑日,1,5,56
2012,福井県,73,70,34,32,真夏日,32,38,57
2012,福井県,28,16,14,11,猛暑日,11,5,57
2012,滋賀県,73,66,34,27,真夏日,27,39,60
2012,滋賀県,15,4,13,4,猛暑日,4,0,60
2012,京都府,85,79,42,37,真夏日,37,42,61
2012,京都府,37,21,20,14,猛暑日,14,7,61
2012,大阪府,87,75,42,35,真夏日,35,40,62
2012,大阪府,27,12,17,10,猛暑日,10,2,62
2012,兵庫県,87,61,47,27,真夏日,27,34,63
2012,兵庫県,34,8,19,5,猛暑日,5,3,63
2012,奈良県,75,70,37,34,真夏日,34,36,64
2012,奈良県,13,9,12,8,猛暑日,8,1,64
2012,和歌山県,81,66,41,29,真夏日,29,37,65
2012,和歌山県,12,6,6,4,猛暑日,4,2,65
2012,岡山県,82,70,41,35,真夏日,35,35,66
2012,岡山県,23,11,16,8,猛暑日,8,3,66
2012,広島県,81,71,37,32,真夏日,32,39,67
2012,広島県,23,9,15,8,猛暑日,8,1,67
2012,島根県,75,65,39,31,真夏日,31,34,68
2012,島根県,27,14,14,8,猛暑日,8,6,68
2012,鳥取県,76,73,38,36,真夏日,36,37,69
2012,鳥取県,31,27,17,16,猛暑日,16,11,69
2012,徳島県,72,64,34,29,真夏日,29,35,71
2012,徳島県,3,1,3,1,猛暑日,1,0,71
2012,香川県,78,73,41,38,真夏日,38,35,72
2012,香川県,27,16,14,9,猛暑日,9,7,72
2012,愛媛県,83,70,43,31,真夏日,31,39,73
2012,愛媛県,21,9,15,7,猛暑日,7,2,73
2012,高知県,89,67,49,35,真夏日,35,32,74
2012,高知県,8,0,7,0,猛暑日,0,0,74
2012,山口県,77,62,39,32,真夏日,32,30,81
2012,山口県,14,6,11,6,猛暑日,6,0,81
2012,福岡県,84,63,47,33,真夏日,33,30,82
2012,福岡県,29,10,18,7,猛暑日,7,3,82
2012,大分県,91,62,52,31,真夏日,31,31,83
2012,大分県,23,2,15,1,猛暑日,1,1,83
2012,長崎県,73,56,35,26,真夏日,26,30,84
2012,長崎県,12,6,9,5,猛暑日,5,1,84
2012,佐賀県,74,70,41,38,真夏日,38,32,85
2012,佐賀県,20,19,13,12,猛暑日,12,7,85
2012,熊本県,90,76,48,39,真夏日,39,37,86
2012,熊本県,21,11,11,10,猛暑日,10,1,86
2012,宮崎県,90,63,50,31,真夏日,31,32,87
2012,宮崎県,7,1,3,0,猛暑日,0,1,87
2012,鹿児島県,107,72,64,35,真夏日,35,37,88
2012,鹿児島県,10,1,6,1,猛暑日,1,0,88
2012,沖縄県,127,83,77,48,真夏日,48,35,91
2012,沖縄県,1,0,1,0,猛暑日,0,0,91
2013,東京都,137,58,70,28,真夏日,28,30,1
2013,東京都,19,12,10,6,猛暑日,6,6,1
2013,北海道,45,9,35,6,真夏日,6,3,24
2013,北海道,0,0,0,0,猛暑日,0,0,24
2013,青森県,30,19,14,6,真夏日,6,13,31
2013,青森県,1,0,0,0,猛暑日,0,0,31
2013,秋田県,47,23,26,13,真夏日,13,10,32
2013,秋田県,1,0,1,0,猛暑日,0,0,32
2013,岩手県,46,19,21,7,真夏日,7,12,33
2013,岩手県,5,0,0,0,猛暑日,0,0,33
2013,宮城県,32,21,9,7,真夏日,7,14,34
2013,宮城県,5,1,0,0,猛暑日,0,1,34
2013,山形県,48,37,26,19,真夏日,19,18,35
2013,山形県,5,5,0,0,猛暑日,0,5,35
2013,福島県,71,53,37,24,真夏日,24,29,36
2013,福島県,11,7,3,0,猛暑日,0,7,36
2013,茨城県,73,39,36,16,真夏日,16,23,40
2013,茨城県,21,2,7,0,猛暑日,0,2,40
2013,栃木県,65,50,34,23,真夏日,23,27,41
2013,栃木県,20,5,10,1,猛暑日,1,4,41
2013,群馬県,83,67,48,37,真夏日,37,30,42
2013,群馬県,26,17,11,8,猛暑日,8,9,42
2013,埼玉県,78,65,42,34,真夏日,34,31,43
2013,埼玉県,25,20,11,8,猛暑日,8,12,43
2013,千葉県,69,56,32,27,真夏日,27,29,45
2013,千葉県,22,6,9,3,猛暑日,3,3,45
2013,神奈川県,65,56,28,27,真夏日,27,29,46
2013,神奈川県,10,4,3,1,猛暑日,1,3,46
2013,長野県,90,48,55,29,真夏日,29,19,48
2013,長野県,23,5,10,1,猛暑日,1,4,48
2013,山梨県,98,88,53,48,真夏日,48,40,49
2013,山梨県,33,31,17,16,猛暑日,16,15,49
2013,静岡県,95,62,44,28,真夏日,28,34,50
2013,静岡県,28,3,14,0,猛暑日,0,3,50
2013,愛知県,95,88,49,47,真夏日,47,41,51
2013,愛知県,32,27,16,13,猛暑日,13,14,51
2013,岐阜県,104,82,57,45,真夏日,45,37,52
2013,岐阜県,34,25,19,12,猛暑日,12,13,52
2013,三重県,96,65,51,36,真夏日,36,29,53
2013,三重県,33,16,17,10,猛暑日,10,6,53
2013,新潟県,75,36,43,15,真夏日,15,21,54
2013,新潟県,13,1,5,0,猛暑日,0,1,54
2013,富山県,70,63,42,38,真夏日,38,25,55
2013,富山県,12,9,4,4,猛暑日,4,5,55
2013,石川県,64,51,38,30,真夏日,30,21,56
2013,石川県,8,4,2,1,猛暑日,1,3,56
2013,福井県,81,72,47,41,真夏日,41,31,57
2013,福井県,17,9,6,2,猛暑日,2,7,57
2013,滋賀県,80,62,46,37,真夏日,37,25,60
2013,滋賀県,21,8,9,2,猛暑日,2,6,60
2013,京都府,102,92,61,54,真夏日,54,38,61
2013,京都府,38,30,22,16,猛暑日,16,14,61
2013,大阪府,99,88,56,49,真夏日,49,39,62
2013,大阪府,35,23,20,9,猛暑日,9,14,62
2013,兵庫県,106,66,63,36,真夏日,36,30,63
2013,兵庫県,33,8,19,2,猛暑日,2,6,63
2013,奈良県,91,81,54,48,真夏日,48,33,64
2013,奈良県,31,20,17,7,猛暑日,7,13,64
2013,和歌山県,94,76,50,42,真夏日,42,34,65
2013,和歌山県,34,12,20,7,猛暑日,7,5,65
2013,岡山県,100,75,58,47,真夏日,47,28,66
2013,岡山県,35,20,22,12,猛暑日,12,8,66
2013,広島県,99,77,56,41,真夏日,41,36,67
2013,広島県,27,14,14,2,猛暑日,2,12,67
2013,島根県,94,65,59,40,真夏日,40,25,68
2013,島根県,23,4,10,0,猛暑日,0,4,68
2013,鳥取県,84,78,51,46,真夏日,46,32,69
2013,鳥取県,20,17,8,7,猛暑日,7,10,69
2013,徳島県,93,69,50,39,真夏日,39,30,71
2013,徳島県,27,14,15,3,猛暑日,3,11,71
2013,香川県,100,84,61,52,真夏日,52,32,72
2013,香川県,35,29,20,17,猛暑日,17,12,72
2013,愛媛県,104,82,58,43,真夏日,43,39,73
2013,愛媛県,41,12,26,6,猛暑日,6,6,73
2013,高知県,98,84,52,44,真夏日,44,40,74
2013,高知県,40,9,25,4,猛暑日,4,5,74
2013,山口県,94,84,53,49,真夏日,49,35,81
2013,山口県,32,23,19,14,猛暑日,14,9,81
2013,福岡県,103,77,59,44,真夏日,44,33,82
2013,福岡県,38,30,25,17,猛暑日,17,13,82
2013,大分県,105,66,61,42,真夏日,42,24,83
2013,大分県,43,24,28,10,猛暑日,10,14,83
2013,長崎県,92,73,49,35,真夏日,35,38,84
2013,長崎県,22,6,9,0,猛暑日,0,6,84
2013,佐賀県,92,87,51,48,真夏日,48,39,85
2013,佐賀県,17,15,4,2,猛暑日,2,13,85
2013,熊本県,115,100,63,54,真夏日,54,46,86
2013,熊本県,27,15,13,2,猛暑日,2,13,86
2013,宮崎県,105,74,56,44,真夏日,44,30,87
2013,宮崎県,45,21,32,13,猛暑日,13,8,87
2013,鹿児島県,131,98,70,47,真夏日,47,51,88
2013,鹿児島県,38,28,22,14,猛暑日,14,14,88
2013,沖縄県,150,119,83,65,真夏日,65,54,91
2013,沖縄県,3,0,3,0,猛暑日,0,0,91
2014,東京都,131,45,60,30,真夏日,30,15,1
2014,東京都,18,5,13,5,猛暑日,5,0,1
2014,北海道,35,12,32,12,真夏日,12,0,24
2014,北海道,2,0,2,0,猛暑日,0,0,24
2014,青森県,33,16,26,10,真夏日,10,6,31
2014,青森県,0,0,0,0,猛暑日,0,0,31
2014,秋田県,45,23,37,21,真夏日,21,2,32
2014,秋田県,2,0,2,0,猛暑日,0,0,32
2014,岩手県,48,24,38,20,真夏日,20,4,33
2014,岩手県,6,0,6,0,猛暑日,0,0,33
2014,宮城県,37,26,26,20,真夏日,20,6,34
2014,宮城県,5,1,4,0,猛暑日,0,1,34
2014,山形県,48,40,37,31,真夏日,31,9,35
2014,山形県,7,7,7,7,猛暑日,7,0,35
2014,福島県,56,43,43,33,真夏日,33,10,36
2014,福島県,13,11,11,9,猛暑日,9,2,36
2014,茨城県,55,36,37,25,真夏日,25,11,40
2014,茨城県,15,5,13,4,猛暑日,4,1,40
2014,栃木県,57,42,41,28,真夏日,28,14,41
2014,栃木県,17,6,13,5,猛暑日,5,1,41
2014,群馬県,68,52,50,39,真夏日,39,13,42
2014,群馬県,23,18,17,14,猛暑日,14,4,42
2014,埼玉県,65,52,46,38,真夏日,38,14,43
2014,埼玉県,19,15,15,12,猛暑日,12,3,43
2014,千葉県,58,49,37,31,真夏日,31,18,45
2014,千葉県,17,1,12,1,猛暑日,1,0,45
2014,神奈川県,48,44,31,29,真夏日,29,15,46
2014,神奈川県,9,1,7,1,猛暑日,1,0,46
2014,長野県,62,36,44,28,真夏日,28,8,48
2014,長野県,12,7,10,7,猛暑日,7,0,48
2014,山梨県,72,64,51,45,真夏日,45,19,49
2014,山梨県,21,16,15,12,猛暑日,12,4,49
2014,静岡県,77,42,47,26,真夏日,26,16,50
2014,静岡県,11,3,9,1,猛暑日,1,2,50
2014,愛知県,75,68,48,45,真夏日,45,23,51
2014,愛知県,14,8,10,6,猛暑日,6,2,51
2014,岐阜県,86,69,56,46,真夏日,46,23,52
2014,岐阜県,16,9,13,8,猛暑日,8,1,52
2014,三重県,80,40,52,25,真夏日,25,15,53
2014,三重県,10,3,9,3,猛暑日,3,0,53
2014,新潟県,54,28,37,19,真夏日,19,9,54
2014,新潟県,10,2,9,2,猛暑日,2,0,54
2014,富山県,48,39,34,28,真夏日,28,11,55
2014,富山県,9,6,7,4,猛暑日,4,2,55
2014,石川県,46,34,33,21,真夏日,21,13,56
2014,石川県,6,3,5,3,猛暑日,3,0,56
2014,福井県,54,47,42,37,真夏日,37,10,57
2014,福井県,12,8,8,5,猛暑日,5,3,57
2014,滋賀県,65,45,44,30,真夏日,30,15,60
2014,滋賀県,7,3,6,3,猛暑日,3,0,60
2014,京都府,83,72,55,49,真夏日,49,23,61
2014,京都府,17,13,13,10,猛暑日,10,3,61
2014,大阪府,85,65,54,39,真夏日,39,26,62
2014,大阪府,9,5,8,5,猛暑日,5,0,62
2014,兵庫県,78,44,49,27,真夏日,27,17,63
2014,兵庫県,9,1,6,1,猛暑日,1,0,63
2014,奈良県,65,60,44,41,真夏日,41,19,64
2014,奈良県,10,5,10,5,猛暑日,5,0,64
2014,和歌山県,70,57,40,31,真夏日,31,26,65
2014,和歌山県,7,2,7,2,猛暑日,2,0,65
2014,岡山県,72,58,45,36,真夏日,36,22,66
2014,岡山県,6,3,6,3,猛暑日,3,0,66
2014,広島県,74,49,43,26,真夏日,26,23,67
2014,広島県,6,2,6,2,猛暑日,2,0,67
2014,島根県,56,37,39,29,真夏日,29,8,68
2014,島根県,5,4,4,4,猛暑日,4,0,68
2014,鳥取県,57,49,42,37,真夏日,37,12,69
2014,鳥取県,8,7,6,5,猛暑日,5,2,69
2014,徳島県,66,46,35,27,真夏日,27,19,71
2014,徳島県,5,1,5,1,猛暑日,1,0,71
2014,香川県,69,58,43,35,真夏日,35,23,72
2014,香川県,7,4,5,3,猛暑日,3,1,72
2014,愛媛県,76,53,42,27,真夏日,27,26,73
2014,愛媛県,8,6,6,4,猛暑日,4,2,73
2014,高知県,79,48,43,27,真夏日,27,21,74
2014,高知県,9,3,8,2,猛暑日,2,1,74
2014,山口県,64,53,36,32,真夏日,32,21,81
2014,山口県,5,4,5,4,猛暑日,4,0,81
2014,福岡県,78,48,43,32,真夏日,32,16,82
2014,福岡県,6,2,6,2,猛暑日,2,0,82
2014,大分県,73,38,40,22,真夏日,22,16,83
2014,大分県,9,1,8,1,猛暑日,1,0,83
2014,長崎県,60,37,32,21,真夏日,21,16,84
2014,長崎県,5,1,5,1,猛暑日,1,0,84
2014,佐賀県,61,54,33,31,真夏日,31,23,85
2014,佐賀県,3,3,3,3,猛暑日,3,0,85
2014,熊本県,88,60,46,32,真夏日,32,28,86
2014,熊本県,5,4,5,4,猛暑日,4,0,86
2014,宮崎県,85,50,46,27,真夏日,27,23,87
2014,宮崎県,9,4,8,4,猛暑日,4,0,87
2014,鹿児島県,109,62,54,31,真夏日,31,31,88
2014,鹿児島県,5,2,5,2,猛暑日,2,0,88
2014,沖縄県,152,105,86,52,真夏日,52,53,91
2014,沖縄県,5,0,3,0,猛暑日,0,0,91
2015,東京都,152,47,83,33,真夏日,33,14,1
2015,東京都,18,11,17,10,猛暑日,10,1,1
2015,北海道,35,6,30,6,真夏日,6,0,24
2015,北海道,2,0,2,0,猛暑日,0,0,24
2015,青森県,30,14,24,11,真夏日,11,3,31
2015,青森県,2,1,2,1,猛暑日,1,0,31
2015,秋田県,41,23,32,17,真夏日,17,6,32
2015,秋田県,4,1,4,1,猛暑日,1,0,32
2015,岩手県,45,26,38,22,真夏日,22,4,33
2015,岩手県,10,2,10,2,猛暑日,2,0,33
2015,宮城県,42,28,35,22,真夏日,22,6,34
2015,宮城県,10,5,10,5,猛暑日,5,0,34
2015,山形県,49,40,39,32,真夏日,32,8,35
2015,山形県,12,12,12,12,猛暑日,12,0,35
2015,福島県,58,49,48,40,真夏日,40,9,36
2015,福島県,17,16,16,15,猛暑日,15,1,36
2015,茨城県,55,40,41,31,真夏日,31,9,40
2015,茨城県,19,4,19,4,猛暑日,4,0,40
2015,栃木県,57,45,43,36,真夏日,36,9,41
2015,栃木県,20,12,19,12,猛暑日,12,0,41
2015,群馬県,68,50,51,39,真夏日,39,11,42
2015,群馬県,30,18,26,18,猛暑日,18,0,42
2015,埼玉県,62,50,47,36,真夏日,36,14,43
2015,埼玉県,22,15,20,15,猛暑日,15,0,43
2015,千葉県,55,44,35,29,真夏日,29,15,45
2015,千葉県,16,4,15,4,猛暑日,4,0,45
2015,神奈川県,48,40,31,28,真夏日,28,12,46
2015,神奈川県,5,2,4,2,猛暑日,2,0,46
2015,長野県,61,40,46,32,真夏日,32,8,48
2015,長野県,23,7,22,7,猛暑日,7,0,48
2015,山梨県,72,65,51,45,真夏日,45,20,49
2015,山梨県,28,23,21,19,猛暑日,19,4,49
2015,静岡県,66,41,43,27,真夏日,27,14,50
2015,静岡県,20,4,16,3,猛暑日,3,1,50
2015,愛知県,62,54,39,36,真夏日,36,18,51
2015,愛知県,18,16,14,12,猛暑日,12,4,51
2015,岐阜県,73,59,45,41,真夏日,41,18,52
2015,岐阜県,26,16,20,14,猛暑日,14,2,52
2015,三重県,64,41,38,27,真夏日,27,14,53
2015,三重県,18,2,15,1,猛暑日,1,1,53
2015,新潟県,55,28,40,25,真夏日,25,3,54
2015,新潟県,12,1,11,1,猛暑日,1,0,54
2015,富山県,50,43,34,32,真夏日,32,11,55
2015,富山県,12,7,12,7,猛暑日,7,0,55
2015,石川県,50,36,36,29,真夏日,29,7,56
2015,石川県,9,4,9,4,猛暑日,4,0,56
2015,福井県,58,50,38,34,真夏日,34,16,57
2015,福井県,13,11,13,11,猛暑日,11,0,57
2015,滋賀県,57,42,39,28,真夏日,28,14,60
2015,滋賀県,11,7,10,7,猛暑日,7,0,60
2015,京都府,73,68,51,48,真夏日,48,20,61
2015,京都府,22,21,19,18,猛暑日,18,3,61
2015,大阪府,73,58,49,37,真夏日,37,21,62
2015,大阪府,18,11,16,10,猛暑日,10,1,62
2015,兵庫県,70,42,49,28,真夏日,28,14,63
2015,兵庫県,18,3,16,3,猛暑日,3,0,63
2015,奈良県,59,52,39,35,真夏日,35,17,64
2015,奈良県,13,11,12,10,猛暑日,10,1,64
2015,和歌山県,64,51,39,30,真夏日,30,21,65
2015,和歌山県,12,6,10,4,猛暑日,4,2,65
2015,岡山県,67,52,48,38,真夏日,38,14,66
2015,岡山県,18,14,16,12,猛暑日,12,2,66
2015,広島県,61,42,43,28,真夏日,28,14,67
2015,広島県,15,5,13,4,猛暑日,4,1,67
2015,島根県,56,33,43,25,真夏日,25,8,68
2015,島根県,13,3,12,3,猛暑日,3,0,68
2015,鳥取県,56,47,40,33,真夏日,33,14,69
2015,鳥取県,12,7,12,7,猛暑日,7,0,69
2015,徳島県,64,44,37,27,真夏日,27,17,71
2015,徳島県,8,5,6,4,猛暑日,4,1,71
2015,香川県,59,53,39,34,真夏日,34,19,72
2015,香川県,16,15,14,13,猛暑日,13,2,72
2015,愛媛県,65,43,41,30,真夏日,30,13,73
2015,愛媛県,15,1,13,1,猛暑日,1,0,73
2015,高知県,70,50,39,28,真夏日,28,22,74
2015,高知県,17,4,14,4,猛暑日,4,0,74
2015,山口県,59,46,40,30,真夏日,30,16,81
2015,山口県,13,13,11,11,猛暑日,11,2,81
2015,福岡県,69,42,44,29,真夏日,29,13,82
2015,福岡県,18,4,16,3,猛暑日,3,1,82
2015,大分県,69,40,44,26,真夏日,26,14,83
2015,大分県,22,6,16,5,猛暑日,5,1,83
2015,長崎県,49,37,28,23,真夏日,23,14,84
2015,長崎県,7,1,6,1,猛暑日,1,0,84
2015,佐賀県,56,53,36,34,真夏日,34,19,85
2015,佐賀県,13,11,12,10,猛暑日,10,1,85
2015,熊本県,72,56,41,35,真夏日,35,21,86
2015,熊本県,15,10,13,9,猛暑日,9,1,86
2015,宮崎県,78,46,43,26,真夏日,26,20,87
2015,宮崎県,16,2,12,2,猛暑日,2,0,87
2015,鹿児島県,122,55,70,28,真夏日,28,27,88
2015,鹿児島県,13,4,12,3,猛暑日,3,1,88
2015,沖縄県,161,110,89,66,真夏日,66,44,91
2015,沖縄県,0,0,0,0,猛暑日,0,0,91
2016,東京都,151,57,73,26,真夏日,26,31,1
2016,東京都,6,3,5,3,猛暑日,3,0,1
2016,北海道,43,11,24,5,真夏日,5,6,24
2016,北海道,0,0,0,0,猛暑日,0,0,24
2016,青森県,41,13,19,9,真夏日,9,4,31
2016,青森県,2,0,2,0,猛暑日,0,0,31
2016,秋田県,55,38,31,18,真夏日,18,20,32
2016,秋田県,4,2,2,2,猛暑日,2,0,32
2016,岩手県,50,31,24,14,真夏日,14,17,33
2016,岩手県,3,0,2,0,猛暑日,0,0,33
2016,宮城県,41,26,23,15,真夏日,15,11,34
2016,宮城県,1,1,0,0,猛暑日,0,1,34
2016,山形県,57,42,28,17,真夏日,17,25,35
2016,山形県,5,2,2,1,猛暑日,1,1,35
2016,福島県,72,48,43,27,真夏日,27,21,36
2016,福島県,10,5,6,3,猛暑日,3,2,36
2016,茨城県,70,38,38,24,真夏日,24,14,40
2016,茨城県,10,2,8,1,猛暑日,1,1,40
2016,栃木県,66,54,38,29,真夏日,29,25,41
2016,栃木県,10,3,8,2,猛暑日,2,1,41
2016,群馬県,75,57,44,34,真夏日,34,23,42
2016,群馬県,24,6,18,5,猛暑日,5,1,42
2016,埼玉県,76,60,42,33,真夏日,33,27,43
2016,埼玉県,14,6,10,5,猛暑日,5,1,43
2016,千葉県,72,53,35,24,真夏日,24,29,45
2016,千葉県,4,1,4,1,猛暑日,1,0,45
2016,神奈川県,66,54,32,25,真夏日,25,29,46
2016,神奈川県,6,1,4,1,猛暑日,1,0,46
2016,長野県,82,59,49,33,真夏日,33,26,48
2016,長野県,13,3,7,1,猛暑日,1,2,48
2016,山梨県,87,86,54,53,真夏日,53,33,49
2016,山梨県,19,17,15,14,猛暑日,14,3,49
2016,静岡県,89,61,46,26,真夏日,26,35,50
2016,静岡県,14,4,8,3,猛暑日,3,1,50
2016,愛知県,86,74,46,40,真夏日,40,34,51
2016,愛知県,21,9,10,5,猛暑日,5,4,51
2016,岐阜県,93,78,53,45,真夏日,45,33,52
2016,岐阜県,27,18,16,11,猛暑日,11,7,52
2016,三重県,90,54,50,29,真夏日,29,25,53
2016,三重県,24,6,14,3,猛暑日,3,3,53
2016,新潟県,66,34,34,14,真夏日,14,20,54
2016,新潟県,11,2,3,0,猛暑日,0,2,54
2016,富山県,65,56,37,31,真夏日,31,25,55
2016,富山県,6,4,3,2,猛暑日,2,2,55
2016,石川県,62,55,34,29,真夏日,29,26,56
2016,石川県,5,1,4,1,猛暑日,1,0,56
2016,福井県,71,63,41,35,真夏日,35,28,57
2016,福井県,11,5,5,3,猛暑日,3,2,57
2016,滋賀県,80,58,45,33,真夏日,33,25,60
2016,滋賀県,17,2,7,2,猛暑日,2,0,60
2016,京都府,93,87,55,51,真夏日,51,36,61
2016,京都府,32,27,16,13,猛暑日,13,14,61
2016,大阪府,92,81,53,43,真夏日,43,38,62
2016,大阪府,28,26,11,10,猛暑日,10,16,62
2016,兵庫県,96,62,56,31,真夏日,31,31,63
2016,兵庫県,28,10,13,3,猛暑日,3,7,63
2016,奈良県,78,76,42,40,真夏日,40,36,64
2016,奈良県,26,17,13,7,猛暑日,7,10,64
2016,和歌山県,95,74,50,38,真夏日,38,36,65
2016,和歌山県,20,12,7,4,猛暑日,4,8,65
2016,岡山県,84,77,47,43,真夏日,43,34,66
2016,岡山県,27,22,13,9,猛暑日,9,13,66
2016,広島県,87,70,49,36,真夏日,36,34,67
2016,広島県,28,16,14,4,猛暑日,4,12,67
2016,島根県,85,56,50,30,真夏日,30,26,68
2016,島根県,19,5,8,1,猛暑日,1,4,68
2016,鳥取県,75,65,45,36,真夏日,36,29,69
2016,鳥取県,13,10,9,7,猛暑日,7,3,69
2016,徳島県,87,67,48,35,真夏日,35,32,71
2016,徳島県,23,9,10,5,猛暑日,5,4,71
2016,香川県,85,78,47,45,真夏日,45,33,72
2016,香川県,25,18,10,6,猛暑日,6,12,72
2016,愛媛県,99,74,52,37,真夏日,37,37,73
2016,愛媛県,31,11,14,2,猛暑日,2,9,73
2016,高知県,102,76,52,37,真夏日,37,39,74
2016,高知県,28,5,13,1,猛暑日,1,4,74
2016,山口県,85,74,46,41,真夏日,41,33,81
2016,山口県,26,18,11,8,猛暑日,8,10,81
2016,福岡県,106,75,62,43,真夏日,43,32,82
2016,福岡県,38,22,22,13,猛暑日,13,9,82
2016,大分県,108,69,61,37,真夏日,37,32,83
2016,大分県,41,7,23,2,猛暑日,2,5,83
2016,長崎県,85,67,44,36,真夏日,36,31,84
2016,長崎県,26,8,9,1,猛暑日,1,7,84
2016,佐賀県,90,89,51,51,真夏日,51,38,85
2016,佐賀県,28,26,13,11,猛暑日,11,15,85
2016,熊本県,110,92,60,49,真夏日,49,43,86
2016,熊本県,33,26,15,9,猛暑日,9,17,86
2016,宮崎県,109,76,54,39,真夏日,39,37,87
2016,宮崎県,29,0,14,0,猛暑日,0,0,87
2016,鹿児島県,148,95,74,45,真夏日,45,50,88
2016,鹿児島県,27,11,8,1,猛暑日,1,10,88
2016,沖縄県,185,137,99,69,真夏日,69,68,91
2016,沖縄県,6,0,5,0,猛暑日,0,0,91
2017,東京都,168,51,84,35,真夏日,35,16,1
2017,東京都,7,2,6,2,猛暑日,2,0,1
2017,北海道,32,7,29,7,真夏日,7,0,24
2017,北海道,5,0,5,0,猛暑日,0,0,24
2017,青森県,25,15,23,15,真夏日,15,0,31
2017,青森県,3,1,3,1,猛暑日,1,0,31
2017,秋田県,40,25,30,19,真夏日,19,6,32
2017,秋田県,4,1,4,1,猛暑日,1,0,32
2017,岩手県,38,19,32,18,真夏日,18,1,33
2017,岩手県,6,1,6,1,猛暑日,1,0,33
2017,宮城県,34,19,26,13,真夏日,13,6,34
2017,宮城県,0,0,0,0,猛暑日,0,0,34
2017,山形県,50,37,35,28,真夏日,28,9,35
2017,山形県,5,4,5,4,猛暑日,4,0,35
2017,福島県,56,43,42,35,真夏日,35,8,36
2017,福島県,9,6,8,6,猛暑日,6,0,36
2017,茨城県,65,33,45,24,真夏日,24,9,40
2017,茨城県,9,1,8,0,猛暑日,0,1,40
2017,栃木県,63,46,43,31,真夏日,31,15,41
2017,栃木県,9,1,8,1,猛暑日,1,0,41
2017,群馬県,80,60,51,43,真夏日,43,17,42
2017,群馬県,21,8,19,7,猛暑日,7,1,42
2017,埼玉県,72,58,48,41,真夏日,41,17,43
2017,埼玉県,13,3,11,2,猛暑日,2,1,43
2017,千葉県,70,53,43,35,真夏日,35,18,45
2017,千葉県,7,3,3,1,猛暑日,1,2,45
2017,神奈川県,58,48,39,33,真夏日,33,15,46
2017,神奈川県,3,2,1,1,猛暑日,1,1,46
2017,長野県,78,44,51,34,真夏日,34,10,48
2017,長野県,11,3,10,3,猛暑日,3,0,48
2017,山梨県,87,80,57,52,真夏日,52,28,49
2017,山梨県,20,15,15,13,猛暑日,13,2,49
2017,静岡県,86,61,51,36,真夏日,36,25,50
2017,静岡県,13,5,8,1,猛暑日,1,4,50
2017,愛知県,85,73,50,44,真夏日,44,29,51
2017,愛知県,11,3,8,2,猛暑日,2,1,51
2017,岐阜県,96,74,59,43,真夏日,43,31,52
2017,岐阜県,16,6,13,5,猛暑日,5,1,52
2017,三重県,86,56,52,34,真夏日,34,22,53
2017,三重県,17,4,11,2,猛暑日,2,2,53
2017,新潟県,58,30,37,22,真夏日,22,8,54
2017,新潟県,9,1,9,1,猛暑日,1,0,54
2017,富山県,51,44,34,29,真夏日,29,15,55
2017,富山県,6,3,6,3,猛暑日,3,0,55
2017,石川県,55,45,37,30,真夏日,30,15,56
2017,石川県,6,3,6,3,猛暑日,3,0,56
2017,福井県,67,58,44,39,真夏日,39,19,57
2017,福井県,10,8,8,7,猛暑日,7,1,57
2017,滋賀県,70,53,46,33,真夏日,33,20,60
2017,滋賀県,2,1,1,1,猛暑日,1,0,60
2017,京都府,90,83,56,52,真夏日,52,31,61
2017,京都府,23,18,15,11,猛暑日,11,7,61
2017,大阪府,83,74,49,42,真夏日,42,32,62
2017,大阪府,20,15,15,12,猛暑日,12,3,62
2017,兵庫県,89,60,56,33,真夏日,33,27,63
2017,兵庫県,23,3,16,2,猛暑日,2,1,63
2017,奈良県,84,76,54,49,真夏日,49,27,64
2017,奈良県,11,9,6,5,猛暑日,5,4,64
2017,和歌山県,85,70,46,39,真夏日,39,31,65
2017,和歌山県,16,8,9,4,猛暑日,4,4,65
2017,岡山県,77,74,48,46,真夏日,46,28,66
2017,岡山県,13,9,8,5,猛暑日,5,4,66
2017,広島県,84,61,53,37,真夏日,37,24,67
2017,広島県,12,5,9,5,猛暑日,5,0,67
2017,島根県,76,49,52,36,真夏日,36,13,68
2017,島根県,12,5,9,4,猛暑日,4,1,68
2017,鳥取県,71,65,50,45,真夏日,45,20,69
2017,鳥取県,14,13,11,10,猛暑日,10,3,69
2017,徳島県,80,67,46,36,真夏日,36,31,71
2017,徳島県,11,3,4,2,猛暑日,2,1,71
2017,香川県,80,72,48,42,真夏日,42,30,72
2017,香川県,23,18,15,11,猛暑日,11,7,72
2017,愛媛県,87,67,51,39,真夏日,39,28,73
2017,愛媛県,25,5,17,4,猛暑日,4,1,73
2017,高知県,94,76,53,41,真夏日,41,35,74
2017,高知県,31,3,16,1,猛暑日,1,2,74
2017,山口県,81,75,51,49,真夏日,49,26,81
2017,山口県,20,15,17,12,猛暑日,12,3,81
2017,福岡県,96,67,60,43,真夏日,43,24,82
2017,福岡県,26,13,19,9,猛暑日,9,4,82
2017,大分県,97,60,59,38,真夏日,38,22,83
2017,大分県,31,5,23,2,猛暑日,2,3,83
2017,長崎県,81,62,49,38,真夏日,38,24,84
2017,長崎県,15,3,15,3,猛暑日,3,0,84
2017,佐賀県,85,78,54,49,真夏日,49,29,85
2017,佐賀県,17,15,16,14,猛暑日,14,1,85
2017,熊本県,92,77,55,45,真夏日,45,32,86
2017,熊本県,21,12,16,12,猛暑日,12,0,86
2017,宮崎県,101,68,57,39,真夏日,39,29,87
2017,宮崎県,29,14,18,7,猛暑日,7,7,87
2017,鹿児島県,136,82,64,42,真夏日,42,40,88
2017,鹿児島県,28,13,18,8,猛暑日,8,5,88
2017,沖縄県,156,121,81,54,真夏日,54,67,91
2017,沖縄県,14,2,7,2,猛暑日,2,0,91
2018,東京都,170,68,85,40,真夏日,40,28,1
2018,東京都,30,12,22,8,猛暑日,8,4,1
2018,北海道,31,8,26,8,真夏日,8,0,24
2018,北海道,4,0,4,0,猛暑日,0,0,24
2018,青森県,41,22,29,15,真夏日,15,7,31
2018,青森県,3,0,2,0,猛暑日,0,0,31
2018,秋田県,50,30,34,21,真夏日,21,9,32
2018,秋田県,8,5,5,3,猛暑日,3,2,32
2018,岩手県,57,39,43,28,真夏日,28,11,33
2018,岩手県,14,2,10,1,猛暑日,1,1,33
2018,宮城県,52,36,38,25,真夏日,25,11,34
2018,宮城県,14,2,10,2,猛暑日,2,0,34
2018,山形県,62,53,44,37,真夏日,37,16,35
2018,山形県,20,14,16,10,猛暑日,10,4,35
2018,福島県,81,64,55,44,真夏日,44,20,36
2018,福島県,33,26,25,22,猛暑日,22,4,36
2018,茨城県,86,58,56,36,真夏日,36,22,40
2018,茨城県,35,9,24,5,猛暑日,5,4,40
2018,栃木県,83,65,56,42,真夏日,42,23,41
2018,栃木県,37,16,27,13,猛暑日,13,3,41
2018,群馬県,89,72,60,51,真夏日,51,21,42
2018,群馬県,41,32,31,24,猛暑日,24,8,42
2018,埼玉県,84,70,54,42,真夏日,42,28,43
2018,埼玉県,40,23,29,18,猛暑日,18,5,43
2018,千葉県,75,66,44,38,真夏日,38,28,45
2018,千葉県,27,5,17,4,猛暑日,4,1,45
2018,神奈川県,74,61,43,37,真夏日,37,24,46
2018,神奈川県,14,7,9,5,猛暑日,5,2,46
2018,長野県,83,63,56,45,真夏日,45,18,48
2018,長野県,37,18,26,12,猛暑日,12,6,48
2018,山梨県,96,86,62,56,真夏日,56,30,49
2018,山梨県,37,31,27,23,猛暑日,23,8,49
2018,静岡県,92,70,54,40,真夏日,40,30,50
2018,静岡県,24,4,18,2,猛暑日,2,2,50
2018,愛知県,86,80,51,47,真夏日,47,33,51
2018,愛知県,37,36,25,24,猛暑日,24,12,51
2018,岐阜県,97,79,60,47,真夏日,47,32,52
2018,岐阜県,43,34,29,24,猛暑日,24,10,52
2018,三重県,85,61,51,38,真夏日,38,23,53
2018,三重県,36,12,25,8,猛暑日,8,4,53
2018,新潟県,71,49,47,35,真夏日,35,14,54
2018,新潟県,24,4,17,3,猛暑日,3,1,54
2018,富山県,72,68,47,45,真夏日,45,23,55
2018,富山県,25,22,17,14,猛暑日,14,8,55
2018,石川県,72,64,47,40,真夏日,40,24,56
2018,石川県,20,10,12,3,猛暑日,3,7,56
2018,福井県,78,73,50,48,真夏日,48,25,57
2018,福井県,28,24,18,16,猛暑日,16,8,57
2018,滋賀県,74,66,46,42,真夏日,42,24,60
2018,滋賀県,30,22,20,15,猛暑日,15,7,60
2018,京都府,86,75,57,48,真夏日,48,27,61
2018,京都府,38,32,26,22,猛暑日,22,10,61
2018,大阪府,81,74,48,44,真夏日,44,30,62
2018,大阪府,36,27,25,20,猛暑日,20,7,62
2018,兵庫県,91,61,59,38,真夏日,38,23,63
2018,兵庫県,39,12,25,9,猛暑日,9,3,63
2018,奈良県,80,72,50,45,真夏日,45,27,64
2018,奈良県,29,29,20,20,猛暑日,20,9,64
2018,和歌山県,82,73,47,42,真夏日,42,31,65
2018,和歌山県,28,12,20,10,猛暑日,10,2,65
2018,岡山県,78,72,47,44,真夏日,44,28,66
2018,岡山県,35,30,23,19,猛暑日,19,11,66
2018,広島県,83,66,51,37,真夏日,37,29,67
2018,広島県,41,28,27,19,猛暑日,19,9,67
2018,島根県,79,57,51,36,真夏日,36,21,68
2018,島根県,37,19,24,10,猛暑日,10,9,68
2018,鳥取県,80,74,52,46,真夏日,46,28,69
2018,鳥取県,32,23,18,13,猛暑日,13,10,69
2018,徳島県,82,64,47,40,真夏日,40,24,71
2018,徳島県,30,12,24,10,猛暑日,10,2,71
2018,香川県,82,68,50,41,真夏日,41,27,72
2018,香川県,36,24,26,18,猛暑日,18,6,72
2018,愛媛県,91,69,51,40,真夏日,40,29,73
2018,愛媛県,35,13,22,6,猛暑日,6,7,73
2018,高知県,90,67,52,38,真夏日,38,29,74
2018,高知県,26,5,21,5,猛暑日,5,0,74
2018,山口県,81,72,49,43,真夏日,43,29,81
2018,山口県,41,35,27,23,猛暑日,23,12,81
2018,福岡県,95,75,58,42,真夏日,42,33,82
2018,福岡県,46,16,30,6,猛暑日,6,10,82
2018,大分県,96,71,60,40,真夏日,40,31,83
2018,大分県,47,14,29,7,猛暑日,7,7,83
2018,長崎県,86,65,49,37,真夏日,37,28,84
2018,長崎県,34,7,23,3,猛暑日,3,4,84
2018,佐賀県,86,82,53,49,真夏日,49,33,85
2018,佐賀県,39,36,26,24,猛暑日,24,12,85
2018,熊本県,108,85,62,49,真夏日,49,36,86
2018,熊本県,44,41,28,26,猛暑日,26,15,86
2018,宮崎県,96,61,57,35,真夏日,35,26,87
2018,宮崎県,22,0,19,0,猛暑日,0,0,87
2018,鹿児島県,133,84,82,44,真夏日,44,40,88
2018,鹿児島県,29,7,22,6,猛暑日,6,1,88
2018,沖縄県,150,105,92,61,真夏日,61,44,91
2018,沖縄県,1,0,0,0,猛暑日,0,0,91
2019,東京都,177,55,84,25,真夏日,25,30,1
2019,東京都,19,12,12,6,猛暑日,6,6,1
2019,北海道,41,18,30,15,真夏日,15,3,24
2019,北海道,7,0,7,0,猛暑日,0,0,24
2019,青森県,37,26,21,15,真夏日,15,11,31
2019,青森県,6,1,3,1,猛暑日,1,0,31
2019,秋田県,56,30,34,16,真夏日,16,14,32
2019,秋田県,12,1,6,0,猛暑日,0,1,32
2019,岩手県,49,31,28,19,真夏日,19,12,33
2019,岩手県,15,3,11,3,猛暑日,3,0,33
2019,宮城県,39,29,23,18,真夏日,18,11,34
2019,宮城県,9,2,9,2,猛暑日,2,0,34
2019,山形県,56,43,32,26,真夏日,26,17,35
2019,山形県,14,11,9,7,猛暑日,7,4,35
2019,福島県,64,46,33,26,真夏日,26,20,36
2019,福島県,25,17,16,12,猛暑日,12,5,36
2019,茨城県,62,42,29,23,真夏日,23,19,40
2019,茨城県,20,6,15,5,猛暑日,5,1,40
2019,栃木県,63,50,30,23,真夏日,23,27,41
2019,栃木県,23,11,15,9,猛暑日,9,2,41
2019,群馬県,69,59,34,29,真夏日,29,30,42
2019,群馬県,22,17,16,12,猛暑日,12,5,42
2019,埼玉県,71,64,32,30,真夏日,30,34,43
2019,埼玉県,24,16,15,12,猛暑日,12,4,43
2019,千葉県,69,54,29,22,真夏日,22,32,45
2019,千葉県,14,0,9,0,猛暑日,0,0,45
2019,神奈川県,66,57,26,24,真夏日,24,33,46
2019,神奈川県,8,1,3,0,猛暑日,0,1,46
2019,長野県,73,48,32,27,真夏日,27,21,48
2019,長野県,19,10,11,6,猛暑日,6,4,48
2019,山梨県,84,75,40,35,真夏日,35,40,49
2019,山梨県,22,19,13,12,猛暑日,12,7,49
2019,静岡県,84,59,36,19,真夏日,19,40,50
2019,静岡県,17,1,7,0,猛暑日,0,1,50
2019,愛知県,81,72,36,32,真夏日,32,40,51
2019,愛知県,27,20,14,9,猛暑日,9,11,51
2019,岐阜県,91,77,46,36,真夏日,36,41,52
2019,岐阜県,30,24,15,13,猛暑日,13,11,52
2019,三重県,83,55,39,23,真夏日,23,32,53
2019,三重県,22,3,11,1,猛暑日,1,2,53
2019,新潟県,69,42,38,22,真夏日,22,20,54
2019,新潟県,20,6,10,1,猛暑日,1,5,54
2019,富山県,58,50,31,27,真夏日,27,23,55
2019,富山県,14,9,9,7,猛暑日,7,2,55
2019,石川県,58,47,31,25,真夏日,25,22,56
2019,石川県,14,6,9,3,猛暑日,3,3,56
2019,福井県,65,58,30,29,真夏日,29,29,57
2019,福井県,20,12,11,7,猛暑日,7,5,57
2019,滋賀県,69,55,33,23,真夏日,23,32,60
2019,滋賀県,20,11,12,7,猛暑日,7,4,60
2019,京都府,90,86,51,48,真夏日,48,38,61
2019,京都府,29,24,15,13,猛暑日,13,11,61
2019,大阪府,95,80,50,40,真夏日,40,40,62
2019,大阪府,25,19,14,9,猛暑日,9,10,62
2019,兵庫県,94,56,51,23,真夏日,23,33,63
2019,兵庫県,25,7,13,3,猛暑日,3,4,63
2019,奈良県,78,76,41,40,真夏日,40,36,64
2019,奈良県,17,17,11,11,猛暑日,11,6,64
2019,和歌山県,84,75,40,36,真夏日,36,39,65
2019,和歌山県,15,9,5,4,猛暑日,4,5,65
2019,岡山県,87,75,44,36,真夏日,36,39,66
2019,岡山県,18,14,10,7,猛暑日,7,7,66
2019,広島県,89,62,43,27,真夏日,27,35,67
2019,広島県,21,7,12,4,猛暑日,4,3,67
2019,島根県,82,48,46,26,真夏日,26,22,68
2019,島根県,19,8,12,6,猛暑日,6,2,68
2019,鳥取県,70,64,38,34,真夏日,34,30,69
2019,鳥取県,24,20,14,13,猛暑日,13,7,69
2019,徳島県,72,57,36,25,真夏日,25,32,71
2019,徳島県,11,4,6,2,猛暑日,2,2,71
2019,香川県,85,69,46,35,真夏日,35,34,72
2019,香川県,15,10,9,5,猛暑日,5,5,72
2019,愛媛県,88,72,43,32,真夏日,32,40,73
2019,愛媛県,17,4,10,1,猛暑日,1,3,73
2019,高知県,83,58,42,22,真夏日,22,36,74
2019,高知県,12,2,9,1,猛暑日,1,1,74
2019,山口県,82,71,44,38,真夏日,38,33,81
2019,山口県,17,11,12,7,猛暑日,7,4,81
2019,福岡県,87,55,53,29,真夏日,29,26,82
2019,福岡県,19,7,11,4,猛暑日,4,3,82
2019,大分県,98,55,56,27,真夏日,27,28,83
2019,大分県,25,3,15,2,猛暑日,2,1,83
2019,長崎県,72,50,37,23,真夏日,23,27,84
2019,長崎県,12,3,7,1,猛暑日,1,2,84
2019,佐賀県,79,71,46,42,真夏日,42,29,85
2019,佐賀県,14,14,8,8,猛暑日,8,6,85
2019,熊本県,95,80,52,42,真夏日,42,38,86
2019,熊本県,17,14,10,10,猛暑日,10,4,86
2019,宮崎県,95,60,48,28,真夏日,28,32,87
2019,宮崎県,10,2,8,2,猛暑日,2,0,87
2019,鹿児島県,121,78,60,31,真夏日,31,47,88
2019,鹿児島県,12,1,9,1,猛暑日,1,0,88
2019,沖縄県,162,89,89,44,真夏日,44,45,91
2019,沖縄県,0,0,0,0,猛暑日,0,0,91
2020,東京都,188,54,89,23,真夏日,23,31,1
2020,東京都,22,12,3,1,猛暑日,1,11,1
2020,北海道,46,12,25,3,真夏日,3,9,24
2020,北海道,3,0,0,0,猛暑日,0,0,24
2020,青森県,39,22,16,5,真夏日,5,17,31
2020,青森県,4,2,0,0,猛暑日,0,2,31
2020,秋田県,50,29,20,8,真夏日,8,21,32
2020,秋田県,7,3,0,0,猛暑日,0,3,32
2020,岩手県,51,29,23,8,真夏日,8,21,33
2020,岩手県,8,0,2,0,猛暑日,0,0,33
2020,宮城県,44,32,16,10,真夏日,10,22,34
2020,宮城県,6,2,0,0,猛暑日,0,2,34
2020,山形県,56,46,23,16,真夏日,16,30,35
2020,山形県,14,11,2,1,猛暑日,1,10,35
2020,福島県,64,55,30,24,真夏日,24,31,36
2020,福島県,19,14,5,4,猛暑日,4,10,36
2020,茨城県,66,48,33,18,真夏日,18,30,40
2020,茨城県,22,3,4,1,猛暑日,1,2,40
2020,栃木県,69,50,35,20,真夏日,20,30,41
2020,栃木県,28,8,5,0,猛暑日,0,8,41
2020,群馬県,74,65,41,32,真夏日,32,33,42
2020,群馬県,26,17,3,2,猛暑日,2,15,42
2020,埼玉県,68,56,35,23,真夏日,23,33,43
2020,埼玉県,28,17,5,3,猛暑日,3,14,43
2020,千葉県,71,51,34,19,真夏日,19,32,45
2020,千葉県,20,2,3,0,猛暑日,0,2,45
2020,神奈川県,58,50,23,18,真夏日,18,32,46
2020,神奈川県,15,5,3,0,猛暑日,0,5,46
2020,長野県,77,48,41,16,真夏日,16,32,48
2020,長野県,23,12,2,1,猛暑日,1,11,48
2020,山梨県,85,74,48,39,真夏日,39,35,49
2020,山梨県,26,24,3,3,猛暑日,3,21,49
2020,静岡県,88,61,45,20,真夏日,20,41,50
2020,静岡県,22,10,3,3,猛暑日,3,7,50
2020,愛知県,83,74,46,38,真夏日,38,36,51
2020,愛知県,32,24,8,2,猛暑日,2,22,51
2020,岐阜県,92,77,51,39,真夏日,39,38,52
2020,岐阜県,30,24,7,5,猛暑日,5,19,52
2020,三重県,85,47,46,19,真夏日,19,28,53
2020,三重県,25,7,6,0,猛暑日,0,7,53
2020,新潟県,64,43,25,13,真夏日,13,30,54
2020,新潟県,15,6,2,0,猛暑日,0,6,54
2020,富山県,61,56,27,23,真夏日,23,33,55
2020,富山県,16,14,3,3,猛暑日,3,11,55
2020,石川県,62,54,27,20,真夏日,20,34,56
2020,石川県,13,8,1,0,猛暑日,0,8,56
2020,福井県,71,60,35,26,真夏日,26,34,57
2020,福井県,19,15,3,3,猛暑日,3,12,57
2020,滋賀県,69,53,34,22,真夏日,22,31,60
2020,滋賀県,24,12,5,1,猛暑日,1,11,60
2020,京都府,84,75,46,37,真夏日,37,38,61
2020,京都府,31,26,6,6,猛暑日,6,20,61
2020,大阪府,81,70,43,34,真夏日,34,36,62
2020,大阪府,25,22,2,0,猛暑日,0,22,62
2020,兵庫県,89,50,50,18,真夏日,18,32,63
2020,兵庫県,32,13,5,0,猛暑日,0,13,63
2020,奈良県,75,70,41,36,真夏日,36,34,64
2020,奈良県,24,24,5,5,猛暑日,5,19,64
2020,和歌山県,78,61,41,28,真夏日,28,33,65
2020,和歌山県,26,13,5,1,猛暑日,1,12,65
2020,岡山県,83,70,46,35,真夏日,35,35,66
2020,岡山県,29,24,3,2,猛暑日,2,22,66
2020,広島県,78,57,43,24,真夏日,24,33,67
2020,広島県,24,15,1,0,猛暑日,0,15,67
2020,島根県,74,52,42,21,真夏日,21,31,68
2020,島根県,29,14,6,3,猛暑日,3,11,68
2020,鳥取県,70,62,36,29,真夏日,29,33,69
2020,鳥取県,24,21,5,3,猛暑日,3,18,69
2020,徳島県,74,59,38,26,真夏日,26,33,71
2020,徳島県,26,14,3,2,猛暑日,2,12,71
2020,香川県,75,69,39,34,真夏日,34,35,72
2020,香川県,27,23,2,1,猛暑日,1,22,72
2020,愛媛県,86,62,49,28,真夏日,28,34,73
2020,愛媛県,36,14,11,2,猛暑日,2,12,73
2020,高知県,85,61,44,25,真夏日,25,36,74
2020,高知県,27,8,10,0,猛暑日,0,8,74
2020,山口県,73,64,40,33,真夏日,33,31,81
2020,山口県,21,15,2,1,猛暑日,1,14,81
2020,福岡県,85,61,50,33,真夏日,33,28,82
2020,福岡県,27,12,7,2,猛暑日,2,10,82
2020,大分県,91,55,55,25,真夏日,25,30,83
2020,大分県,35,8,14,0,猛暑日,0,8,83
2020,長崎県,66,44,35,21,真夏日,21,23,84
2020,長崎県,10,2,0,0,猛暑日,0,2,84
2020,佐賀県,72,68,40,36,真夏日,36,32,85
2020,佐賀県,19,17,3,3,猛暑日,3,14,85
2020,熊本県,84,73,45,37,真夏日,37,36,86
2020,熊本県,25,19,5,2,猛暑日,2,17,86
2020,宮崎県,88,66,51,33,真夏日,33,33,87
2020,宮崎県,24,9,10,5,猛暑日,5,4,87
2020,鹿児島県,123,64,73,34,真夏日,34,30,88
2020,鹿児島県,24,13,8,3,猛暑日,3,10,88
2020,沖縄県,165,108,91,64,真夏日,64,44,91
2020,沖縄県,5,0,5,0,猛暑日,0,0,91
2021,東京都,174,52,83,31,真夏日,31,21,1
2021,東京都,13,2,7,0,猛暑日,0,2,1
2021,北海道,45,27,37,23,真夏日,23,4,24
2021,北海道,21,3,21,3,猛暑日,3,0,24
2021,青森県,39,18,28,15,真夏日,15,3,31
2021,青森県,8,0,8,0,猛暑日,0,0,31
2021,秋田県,54,34,44,32,真夏日,32,2,32
2021,秋田県,15,3,15,3,猛暑日,3,0,32
2021,岩手県,52,30,37,27,真夏日,27,3,33
2021,岩手県,10,7,10,7,猛暑日,7,0,33
2021,宮城県,42,28,26,18,真夏日,18,10,34
2021,宮城県,7,0,7,0,猛暑日,0,0,34
2021,山形県,57,48,40,33,真夏日,33,15,35
2021,山形県,12,10,12,10,猛暑日,10,0,35
2021,福島県,64,48,42,30,真夏日,30,18,36
2021,福島県,14,11,11,10,猛暑日,10,1,36
2021,茨城県,57,32,36,21,真夏日,21,11,40
2021,茨城県,14,1,9,0,猛暑日,0,1,40
2021,栃木県,65,45,41,29,真夏日,29,16,41
2021,栃木県,18,4,13,2,猛暑日,2,2,41
2021,群馬県,70,59,45,39,真夏日,39,20,42
2021,群馬県,22,15,16,10,猛暑日,10,5,42
2021,埼玉県,70,52,43,33,真夏日,33,19,43
2021,埼玉県,23,12,16,8,猛暑日,8,4,43
2021,千葉県,56,46,34,29,真夏日,29,17,45
2021,千葉県,10,1,6,0,猛暑日,0,1,45
2021,神奈川県,54,47,33,30,真夏日,30,17,46
2021,神奈川県,2,1,0,0,猛暑日,0,1,46
2021,長野県,62,45,43,30,真夏日,30,15,48
2021,長野県,19,7,13,7,猛暑日,7,0,48
2021,山梨県,69,66,42,41,真夏日,41,25,49
2021,山梨県,25,16,19,10,猛暑日,10,6,49
2021,静岡県,73,49,42,30,真夏日,30,19,50
2021,静岡県,13,2,5,1,猛暑日,1,1,50
2021,愛知県,84,66,47,42,真夏日,42,24,51
2021,愛知県,18,8,12,5,猛暑日,5,3,51
2021,岐阜県,87,71,50,42,真夏日,42,29,52
2021,岐阜県,25,15,20,10,猛暑日,10,5,52
2021,三重県,83,49,50,33,真夏日,33,16,53
2021,三重県,20,7,12,3,猛暑日,3,4,53
2021,新潟県,63,41,39,30,真夏日,30,11,54
2021,新潟県,15,4,14,4,猛暑日,4,0,54
2021,富山県,65,56,42,36,真夏日,36,20,55
2021,富山県,8,4,7,3,猛暑日,3,1,55
2021,石川県,61,49,39,34,真夏日,34,15,56
2021,石川県,10,4,9,3,猛暑日,3,1,56
2021,福井県,70,58,42,38,真夏日,38,20,57
2021,福井県,14,5,13,5,猛暑日,5,0,57
2021,滋賀県,64,46,41,33,真夏日,33,13,60
2021,滋賀県,9,4,9,4,猛暑日,4,0,60
2021,京都府,87,77,54,49,真夏日,49,28,61
2021,京都府,22,18,17,14,猛暑日,14,4,61
2021,大阪府,88,78,53,46,真夏日,46,32,62
2021,大阪府,21,15,18,15,猛暑日,15,0,62
2021,兵庫県,91,49,52,33,真夏日,33,16,63
2021,兵庫県,21,3,19,3,猛暑日,3,0,63
2021,奈良県,78,76,50,50,真夏日,50,26,64
2021,奈良県,15,9,10,8,猛暑日,8,1,64
2021,和歌山県,82,57,43,37,真夏日,37,20,65
2021,和歌山県,10,3,7,3,猛暑日,3,0,65
2021,岡山県,83,64,48,39,真夏日,39,25,66
2021,岡山県,18,13,16,12,猛暑日,12,1,66
2021,広島県,87,71,49,41,真夏日,41,30,67
2021,広島県,17,7,17,7,猛暑日,7,0,67
2021,島根県,87,49,52,34,真夏日,34,15,68
2021,島根県,15,6,15,6,猛暑日,6,0,68
2021,鳥取県,73,62,42,39,真夏日,39,23,69
2021,鳥取県,13,12,13,12,猛暑日,12,0,69
2021,徳島県,81,53,46,35,真夏日,35,18,71
2021,徳島県,8,6,8,6,猛暑日,6,0,71
2021,香川県,74,61,45,39,真夏日,39,22,72
2021,香川県,14,11,13,10,猛暑日,10,1,72
2021,愛媛県,97,64,51,36,真夏日,36,28,73
2021,愛媛県,19,4,15,3,猛暑日,3,1,73
2021,高知県,95,68,51,36,真夏日,36,32,74
2021,高知県,17,1,12,1,猛暑日,1,0,74
2021,山口県,93,81,54,50,真夏日,50,31,81
2021,山口県,14,11,13,10,猛暑日,10,1,81
2021,福岡県,117,80,67,46,真夏日,46,34,82
2021,福岡県,20,9,19,9,猛暑日,9,0,82
2021,大分県,115,64,64,37,真夏日,37,27,83
2021,大分県,21,1,15,0,猛暑日,0,1,83
2021,長崎県,97,71,50,39,真夏日,39,32,84
2021,長崎県,9,5,9,5,猛暑日,5,0,84
2021,佐賀県,108,105,60,58,真夏日,58,47,85
2021,佐賀県,14,14,14,14,猛暑日,14,0,85
2021,熊本県,118,102,63,55,真夏日,55,47,86
2021,熊本県,16,11,16,11,猛暑日,11,0,86
2021,宮崎県,111,57,55,29,真夏日,29,28,87
2021,宮崎県,8,1,7,1,猛暑日,1,0,87
2021,鹿児島県,146,96,78,45,真夏日,45,51,88
2021,鹿児島県,5,3,4,3,猛暑日,3,0,88
2021,沖縄県,163,121,94,59,真夏日,59,62,91
2021,沖縄県,0,0,0,0,猛暑日,0,0,91
2022,東京都,168,66,90,39,真夏日,39,27,1
2022,東京都,21,16,19,14,猛暑日,14,2,1
2022,北海道,37,10,27,9,真夏日,9,1,24
2022,北海道,0,0,0,0,猛暑日,0,0,24
2022,青森県,40,14,25,8,真夏日,8,6,31
2022,青森県,0,0,0,0,猛暑日,0,0,31
2022,秋田県,65,31,43,23,真夏日,23,8,32
2022,秋田県,1,0,0,0,猛暑日,0,0,32
2022,岩手県,61,29,41,23,真夏日,23,6,33
2022,岩手県,7,0,6,0,猛暑日,0,0,33
2022,宮城県,48,32,31,23,真夏日,23,9,34
2022,宮城県,13,5,10,4,猛暑日,4,1,34
2022,山形県,68,53,43,33,真夏日,33,20,35
2022,山形県,12,7,8,5,猛暑日,5,2,35
2022,福島県,81,58,50,37,真夏日,37,21,36
2022,福島県,21,11,16,9,猛暑日,9,2,36
2022,茨城県,77,53,43,36,真夏日,36,17,40
2022,茨城県,25,14,21,12,猛暑日,12,2,40
2022,栃木県,78,59,44,38,真夏日,38,21,41
2022,栃木県,29,15,25,13,猛暑日,13,2,41
2022,群馬県,80,68,46,43,真夏日,43,25,42
2022,群馬県,28,18,23,15,猛暑日,15,3,42
2022,埼玉県,76,67,43,40,真夏日,40,27,43
2022,埼玉県,29,19,24,17,猛暑日,17,2,43
2022,千葉県,78,60,40,32,真夏日,32,28,45
2022,千葉県,18,2,18,2,猛暑日,2,0,45
2022,神奈川県,75,60,41,36,真夏日,36,24,46
2022,神奈川県,13,5,11,5,猛暑日,5,0,46
2022,長野県,91,68,51,44,真夏日,44,24,48
2022,長野県,19,10,17,8,猛暑日,8,2,48
2022,山梨県,92,81,51,46,真夏日,46,35,49
2022,山梨県,26,21,20,18,猛暑日,18,3,49
2022,静岡県,95,70,50,36,真夏日,36,34,50
2022,静岡県,15,5,12,3,猛暑日,3,2,50
2022,愛知県,97,88,50,45,真夏日,45,43,51
2022,愛知県,24,16,18,12,猛暑日,12,4,51
2022,岐阜県,96,89,50,45,真夏日,45,44,52
2022,岐阜県,29,20,21,17,猛暑日,17,3,52
2022,三重県,97,64,53,36,真夏日,36,28,53
2022,三重県,28,4,21,3,猛暑日,3,1,53
2022,新潟県,86,53,53,37,真夏日,37,16,54
2022,新潟県,19,2,10,0,猛暑日,0,2,54
2022,富山県,77,70,53,47,真夏日,47,23,55
2022,富山県,23,21,14,12,猛暑日,12,9,55
2022,石川県,78,71,50,43,真夏日,43,28,56
2022,石川県,18,11,10,6,猛暑日,6,5,56
2022,福井県,88,77,53,46,真夏日,46,31,57
2022,福井県,26,14,18,10,猛暑日,10,4,57
2022,滋賀県,85,73,48,42,真夏日,42,31,60
2022,滋賀県,20,15,15,10,猛暑日,10,5,60
2022,京都府,100,96,58,54,真夏日,54,42,61
2022,京都府,33,25,23,17,猛暑日,17,8,61
2022,大阪府,103,87,56,46,真夏日,46,41,62
2022,大阪府,31,14,18,10,猛暑日,10,4,62
2022,兵庫県,104,73,58,37,真夏日,37,36,63
2022,兵庫県,41,2,25,2,猛暑日,2,0,63
2022,奈良県,95,89,54,51,真夏日,51,38,64
2022,奈良県,24,16,17,11,猛暑日,11,5,64
2022,和歌山県,93,82,49,43,真夏日,43,39,65
2022,和歌山県,24,6,15,4,猛暑日,4,2,65
2022,岡山県,101,93,55,52,真夏日,52,41,66
2022,岡山県,22,15,17,12,猛暑日,12,3,66
2022,広島県,109,85,63,48,真夏日,48,37,67
2022,広島県,24,8,14,6,猛暑日,6,2,67
2022,島根県,94,66,59,43,真夏日,43,23,68
2022,島根県,22,8,16,7,猛暑日,7,1,68
2022,鳥取県,88,83,53,50,真夏日,50,33,69
2022,鳥取県,28,19,18,16,猛暑日,16,3,69
2022,徳島県,94,74,52,40,真夏日,40,34,71
2022,徳島県,30,6,18,3,猛暑日,3,3,71
2022,香川県,99,90,56,51,真夏日,51,39,72
2022,香川県,32,26,22,16,猛暑日,16,10,72
2022,愛媛県,109,86,59,45,真夏日,45,41,73
2022,愛媛県,35,10,19,7,猛暑日,7,3,73
2022,高知県,106,88,54,43,真夏日,43,45,74
2022,高知県,24,3,13,1,猛暑日,1,2,74
2022,山口県,105,94,62,56,真夏日,56,38,81
2022,山口県,26,16,17,11,猛暑日,11,5,81
2022,福岡県,107,87,64,51,真夏日,51,36,82
2022,福岡県,35,20,22,14,猛暑日,14,6,82
2022,大分県,110,79,65,44,真夏日,44,35,83
2022,大分県,35,6,21,3,猛暑日,3,3,83
2022,長崎県,95,69,54,36,真夏日,36,33,84
2022,長崎県,19,5,11,3,猛暑日,3,2,84
2022,佐賀県,94,90,56,52,真夏日,52,38,85
2022,佐賀県,23,15,14,10,猛暑日,10,5,85
2022,熊本県,107,90,58,48,真夏日,48,42,86
2022,熊本県,28,12,19,10,猛暑日,10,2,86
2022,宮崎県,105,82,54,47,真夏日,47,35,87
2022,宮崎県,24,9,14,4,猛暑日,4,5,87
2022,鹿児島県,126,96,62,47,真夏日,47,49,88
2022,鹿児島県,27,8,16,3,猛暑日,3,5,88
2022,沖縄県,152,109,84,52,真夏日,52,57,91
2022,沖縄県,4,0,1,0,猛暑日,0,0,91
2023,東京都,71,47,71,47,真夏日,47,0,1
2023,東京都,22,17,22,17,猛暑日,17,0,1
2023,北海道,37,12,37,12,真夏日,12,0,24
2023,北海道,8,0,8,0,猛暑日,0,0,24
2023,青森県,28,20,28,20,真夏日,20,0,31
2023,青森県,9,5,9,5,猛暑日,5,0,31
2023,秋田県,35,19,35,19,真夏日,19,0,32
2023,秋田県,7,2,7,2,猛暑日,2,0,32
2023,岩手県,39,24,39,24,真夏日,24,0,33
2023,岩手県,12,5,12,5,猛暑日,5,0,33
2023,宮城県,39,29,39,29,真夏日,29,0,34
2023,宮城県,14,6,14,6,猛暑日,6,0,34
2023,山形県,41,36,41,36,真夏日,36,0,35
2023,山形県,15,11,15,11,猛暑日,11,0,35
2023,福島県,45,41,45,41,真夏日,41,0,36
2023,福島県,19,18,19,18,猛暑日,18,0,36
2023,茨城県,53,34,53,34,真夏日,34,0,40
2023,茨城県,21,11,21,11,猛暑日,11,0,40
2023,栃木県,51,40,51,40,真夏日,40,0,41
2023,栃木県,21,16,21,16,猛暑日,16,0,41
2023,群馬県,58,52,58,52,真夏日,52,0,42
2023,群馬県,24,22,24,22,猛暑日,22,0,42
2023,埼玉県,53,48,53,48,真夏日,48,0,43
2023,埼玉県,25,21,25,21,猛暑日,21,0,43
2023,千葉県,51,43,51,43,真夏日,43,0,45
2023,千葉県,22,5,22,5,猛暑日,5,0,45
2023,神奈川県,44,42,44,42,真夏日,42,0,46
2023,神奈川県,16,6,16,6,猛暑日,6,0,46
2023,長野県,49,38,49,38,真夏日,38,0,48
2023,長野県,22,10,22,10,猛暑日,10,0,48
2023,山梨県,51,45,51,45,真夏日,45,0,49
2023,山梨県,24,20,24,20,猛暑日,20,0,49
2023,静岡県,52,38,52,38,真夏日,38,0,50
2023,静岡県,21,6,21,6,猛暑日,6,0,50
2023,愛知県,55,46,55,46,真夏日,46,0,51
2023,愛知県,27,18,27,18,猛暑日,18,0,51
2023,岐阜県,58,49,58,49,真夏日,49,0,52
2023,岐阜県,26,18,26,18,猛暑日,18,0,52
2023,三重県,54,42,54,42,真夏日,42,0,53
2023,三重県,24,5,24,5,猛暑日,5,0,53
2023,新潟県,42,27,42,27,真夏日,27,0,54
2023,新潟県,17,6,17,6,猛暑日,6,0,54
2023,富山県,48,44,48,44,真夏日,44,0,55
2023,富山県,23,16,23,16,猛暑日,16,0,55
2023,石川県,45,41,45,41,真夏日,41,0,56
2023,石川県,19,9,19,9,猛暑日,9,0,56
2023,福井県,48,45,48,45,真夏日,45,0,57
2023,福井県,23,20,23,20,猛暑日,20,0,57
2023,滋賀県,44,39,44,39,真夏日,39,0,60
2023,滋賀県,21,12,21,12,猛暑日,12,0,60
2023,京都府,49,45,49,45,真夏日,45,0,61
2023,京都府,26,24,26,24,猛暑日,24,0,61
2023,大阪府,49,45,49,45,真夏日,45,0,62
2023,大阪府,21,15,21,15,猛暑日,15,0,62
2023,兵庫県,53,35,53,35,真夏日,35,0,63
2023,兵庫県,24,6,24,6,猛暑日,6,0,63
2023,奈良県,47,45,47,45,真夏日,45,0,64
2023,奈良県,19,17,19,17,猛暑日,17,0,64
2023,和歌山県,51,41,51,41,真夏日,41,0,65
2023,和歌山県,19,3,19,3,猛暑日,3,0,65
2023,岡山県,43,40,43,40,真夏日,40,0,66
2023,岡山県,17,13,17,13,猛暑日,13,0,66
2023,広島県,47,36,47,36,真夏日,36,0,67
2023,広島県,19,10,19,10,猛暑日,10,0,67
2023,島根県,52,32,52,32,真夏日,32,0,68
2023,島根県,21,11,21,11,猛暑日,11,0,68
2023,鳥取県,47,42,47,42,真夏日,42,0,69
2023,鳥取県,22,21,22,21,猛暑日,21,0,69
2023,徳島県,46,36,46,36,真夏日,36,0,71
2023,徳島県,13,2,13,2,猛暑日,2,0,71
2023,香川県,46,42,46,42,真夏日,42,0,72
2023,香川県,18,13,18,13,猛暑日,13,0,72
2023,愛媛県,50,41,50,41,真夏日,41,0,73
2023,愛媛県,17,6,17,6,猛暑日,6,0,73
2023,高知県,58,40,58,40,真夏日,40,0,74
2023,高知県,13,0,13,0,猛暑日,0,0,74
2023,山口県,50,39,50,39,真夏日,39,0,81
2023,山口県,18,7,18,7,猛暑日,7,0,81
2023,福岡県,60,48,60,48,真夏日,48,0,82
2023,福岡県,23,13,23,13,猛暑日,13,0,82
2023,大分県,61,38,61,38,真夏日,38,0,83
2023,大分県,22,1,22,1,猛暑日,1,0,83
2023,長崎県,48,33,48,33,真夏日,33,0,84
2023,長崎県,16,8,16,8,猛暑日,8,0,84
2023,佐賀県,49,45,49,45,真夏日,45,0,85
2023,佐賀県,16,13,16,13,猛暑日,13,0,85
2023,熊本県,62,45,62,45,真夏日,45,0,86
2023,熊本県,22,15,22,15,猛暑日,15,0,86
2023,宮崎県,57,42,57,42,真夏日,42,0,87
2023,宮崎県,11,2,11,2,猛暑日,2,0,87
2023,鹿児島県,66,46,66,46,真夏日,46,0,88
2023,鹿児島県,15,1,15,1,猛暑日,1,0,88
2023,沖縄県,79,49,79,49,真夏日,49,0,91
2023,沖縄県,1,0,1,0,猛暑日,0,0,91
